...X.XXXX..X....X..
.X......XXXXX..XXXX
..XXX.XXX.XXX..XXX.
X..X.XX...X.XXX.XXX
XX....XX.....X.X...
XX.X.XX....X....X..
.X.X.X....XXXX.XXX.
XX..X.XXX.X..X..X..
XX.XX..XXXXX.X..X..
..X....X.XXX.......
.XXX.......X...X...
...X......X.......X
.XXX..X..X..X....XX
...X..XX..X.X.XX..X
X...X...%.X..X...X.
XX..XXX..XX....X...
....X...X.X..XXX...
...XX.X@.X..X..X...
X...X.XX..X..X.X...
