X.X.XX.X..XX.X.X.X
...X.....X.XXX...X
XXXX.XX..X..X.X.XX
XX.X.XX...XXX.X..X
.XX....XX.X...XXX.
.X...X.X.........X
XX.X.......X..XX..
......X..XXX.X.XX.
XX.XX.......XXXX..
X.XXXX.X..XX......
........X.XX.X...X
X.XX..XX.X..@X...X
X.X...XXX.......XX
.X.X....X.X.XX....
X....X.XX...XXX...
.XX.XX.XX....X..X.
..%....X.XXXX..X.X
.X........X..X.X..
