.XX...XX..X...XX.
X..X.XXX..XXX....
.XX..XX.X..XX....
X....XX....X...X.
....X..X.X...X..X
.....X......X.X.X
..X.XX.X...XX.X.@
XX.X......XX.X.X.
XXXX...XX.XX..X..
X..XX..XXX..XX.XX
X..X.......X.X.X.
...XX......X.....
X....X.X.X...XX..
....X..XXXX..X..X
..X.X..X...X..%.X
.X.X.X.....X..XX.
XX....X.XXX...X..
