.XXX.X...XX...X.X.XXX......X....X.X.XX.XX....X.XX.X.XX..X.X.X.XX.X.XX.....X...X....X..XX.XXXXX...X..
XX..X.X.X.XX.X.XX...X.XX.XX...XX..X.XX..X....X.XX.XXX..X....X....X.X..XX.......XX....XXX...X..X....X
X.X.X.X..X.X...X..X..X......X....X...X...XX.X...XX...X.....X...X.XX..X..XX..XXX.....X........X.XXX.X
..X..XX.....X...XX....XX......X.X.X.X.X..XX.XX....X..XX.X....X..XXX.X.X..XX.X.X.X.X...............XX
..X...XX.....XXX.X..X.XXX...X.XXXX.XXX...XX.....X...X.....X..X.X.X...X..X.XX.X.XX.X...XX.XX...X.....
.X....X....XXXXX....XXXX...X.....X..X.XX..X..X.X...XX.X....X...X.X.XX..X...X.X...XX.......XXXX...X..
.XXXXXX.X..XXXXX...XXXX..X.X....XX......X.X.....X........X.XXXX.XXXX..........X.X.X.XX..X........X..
X.X..X..X.X.....XXX.XX.X.X..........X...X...X..X..XXX.XXXXXXXX..X...X..X....XX..X........X.XX.XX..XX
..X...X..X.XXXX.X...X..X.XX...XX..XX.X....X..X.X.XX......X..XX....XX.X.........X.XX.X....X.....X..XX
.X.X...X.X...XXX....X.XX..XXX...X..X.X......XX.X.XX..X...X.X..X.XX..XX.....X.XXXX..X..X.X..X.XX....X
.X.XXXXX..XXXX....X.X.XXXX....X...X...X..X...X.XX...XX..XXXXX...XX..XXX....X..X..X...XXX..XXX..X.XXX
.XX.XXX.XX.....X..X..X.X.X.....XX......XXXX..X.....X.....X.X.XXX.X.X.....XXXXX..X..XXXX...X..X.X....
.....X..X.XX........X.........XXXX.XX....X..X....X.X...X.X.XX.X....X.....X.XX.XXX.XX...X...X.X..X..X
.X.....XX..XX..X.X.XXX......X.XX.XX.......X.X.X........XXXXXXX...XX.......XX.X.....X..XX....X.XX.X.X
XXXX.XX.XXX.....X..X.X.X.XX......X.XX....X.......X..X.X..X..X..XXX.......X..X.XXXXXXX...XX..XXX...XX
...X..X.....X..XX.XX.....X.X..X....X..X...XXX.....X...X..XX.XXXX......X...X.X.....X..XXXX.X.XXX.....
.X....X.X..XX...XXX....XX...X......X.......X.X...X.XX.X.......X.XX..X..X....X.XXX.X..X..XX.XX.X.....
X.X..XXX..X.X...X.X...X..X...XX.X.XXXX.X.X......X..X.XXX...X.....X.....X.X..XXXXX...X.......X..X.XX.
.X..X...X...X..XXX.X..XX.....X.X....X.X.X...X..X.......XX.....XXXX.X.X...X.X...XXXXX...XX..XXX.X...X
.XXX...X............XXX.X.X...XX.XX...X.XX...XX...XXX....X.X...X..X....X..XX.X.X.....XXXXXXXX.XXX.X.
X.X.X.X.....XXXXX.....X...XXXX.X..X..XX..X.XX.X..X..X..XX.X.XXX.......X.X.XXX..X.....X..X.XX.X..X...
X.........XX.X.X.XX.XX.X.XXXXX..X.X...X..X....X.X....XX.X.X..X..XX.XX.XX.X.XX..X..X...X.XXX.XX.X....
XX..XX.X.X.XX.....X..X.X..X.....X.X.....XXX..XX..X..XXXX.X....XXX.XX.....X..XX......X.X...X......XX.
.X..XX....X..X...XXX.X...X..XX.XX.X.X.XX..X.X..X..........XXX...XX..XXX...XX...X.XX......XX....XX.X.
XX..XX.XXX..X.X.XX..X.XX.X...XXXX......X......XXXX......XX.X.....X.X.XX....X..X.......XXX....XX.X...
XX.XX.XXXX.X.X.XX.XX..X........XXXX.X........X....X.XX.X...X.....X..X.X.XXXXXXX...........XX....X.X.
..XX.XXXXXXXXX.X.X.X...XXX...XX.....X....X..........XX...X..X..XX.XX.X.XX.X.X..XX.X...X..X..XXXX.XX.
.......X.....X..X...XX.XXX.X...X..XX...X.XX....X.X...X..X.XXXX...XXXXX...X.XX.XX.XXX.XX...X....X..X.
X...X.XXX.XX...X..X.XXX.X.X..X.X....XX..XX....XXXX.X...X.......X.....X...X......XXX.....XXX.....X.XX
X..XX.X......XXXX..X...XXX.X..X..XX.X................X.X.X....XX.X...X..X.X.XX.XXX...XXX...XX....X.X
.X...X.XX.X.....XXX..X.....XX..X...XXX.X..X......X.XX.XXX...X...XXX.XX....X..XX.X.......XXX.XX..XX.X
.X..X.X.X.......X.....X..X..XX.X..X..X....XX.X...X.XXX...X...X.X.XX.XX..XXX.XXX....XX.X....XXX..XX..
..XXXXX..X.X.X..XX.XX.X...X..X..X.X.XX..X.X........X...X.X...........X..XX..XXXXXXX..XX....X.XX..XX.
...X.X....X......X.X.....XX.......X.X.X.X.X.X.X...XXXX..X..XXXXX.X..X.X.XX..X...X.XXXX.X.....XX.XX..
XX.XX.X.....X..X...X..X.X....XX..XX..XX..X.XXX..............X...X...X.X.....X..X..XX...X.XX.X..XX...
.X.....X...XX...X.X....X.XXX.X.XXX.XX..X.XXX.X..X.X.X..XX.X....X.X.........XXX....X....X..X...XXX...
X..X.X....XX....XX.X.....X..XXXXXXXX..X.XX...XX.X..X..XX....XX..X...X.....XX........XXX..XXX..XX....
X.XXX.........X..X.XX..X.XX.XX.XXXX.X.....X....X....X.XXX....XXXXXX...X...XX...XXXXXX.X.....X..X...X
....XX.XXXX..X.X.X.X..X.X..X.X.X...X.X....X.........X....XXX.X..X.....X..X.X...X.X..X.X.XX..XX.X...X
...X.....X.X..XX.X.X....XXX.X.X..X.X.XX.X..X.X.X.X..X.XX..X.....XX.X.....X@........X.X.X.X..XX.X...X
.XX....XXX.XXXXX...X.X..X..X......XX...X....X.X.......X.X..X.XX....X.X...XX.XX.XXX..XX.XX..XX..X.X.X
.XX..XXX......X...XXX...X.X.....XX..X....X.XXX.X....X...XXXX..X...XX....XX.X...X...XXX....XXXX.XXX..
.XXXX.X.X.X...XX....X..X......X..X.XXX....XX.X..X..X.X.......X.X..X...XXXX.X.X......XX...XXX....X..X
.X..XX...X..X.XX.X.XXX.XX..XX.X...X...XXX...X.....X...XX.X...X.XXX.XX..X.XXX..X..X....X.X.....XX.X..
XX..X..XX....X..X..X.X......XXXX...XX.X.X.......X..XX..X..X...X...XX.XXX..XX......X..X...XXXX...X.XX
XX...XX.X.XXX..........X.X.X.XX.X..XXX.XX.....X.XX........X..XX..X..XX.XX..X..X.X.....X.XXX...X...XX
..X.X...X.X.........XXX...X.X.X........XXX.XX.X.XX..X..X.X...X.XXXX..XXX..........X...X..XXX.XXX.XX.
X.......XX..XXXX..XX.X...XXXX.X.X..X....X..XX....X..X.XX..X.X..X...XXXXX.X...X.......XX.X...X...X.X.
.....X...X...X.X...X...XXX.XXX....X..X..X.....XXX.XX...X.XXXX....X.XX..X.X...X.XX.XXX..XXX......X..X
X..XX.X.XXX.X......X..X.XX.XX.X.X....X.X..XXX..X.X.XX..XX.XX..X.XXX.X..X..X..XXXX.XX.....X.XXXX.....
.X.X..XX..X............XX..XXXX......XX...X..X...X..X..X....X....X..XXXX..X..X.X..XX.XX.XX.X..X.X...
.X....XXX...X.X..XX.......XXX....X....X..X.X.X...X....X....X.X.X.XXX.XX.XX.XX....X..XXX.X..X......X.
XX.XXX.....XXX.XX.XX..XXX.XX...X.XX....XXX..X.XX..X..XX..XX.X..........X...X..X...X.X.........XX..X.
..XX.XXXXX.X.XX.X.X....X.......XX..X.XX.X...X......X.....XX..X..XXXXXXX.X...X.X....XX...XXX.X..X..X.
XX.XXX.XX..X.XXXX..XX.....X.XX..X...XXX..XXXX..XXXX..XXX...X.X..X.X.....XX.......X......X..........X
..X....X.X..X.X...XX.X.XX........XX....X...X..XX.XXXX..XX.X..X.XX...XXXX...X..XX..X.X.XX...X..XXX..X
.X..X..XXX..X.XXX..X.XX.X.......X.X....XXXX.X.XXX...XXX....X.X..X....XXX.X.X.X.X...X...X..XXXXXX....
.....XX.X...XXX.....X.X....X..XXX..XXX.....X...X..XXX..XX..X...XX.....X...X.......XX.......XX.XX.X..
..X...X..X.X....X....X..X...X.X........X.X....XX.X.X...XXX.X.XXXXX..XX....X.X.XX.XXX......X...X.XX.X
XX...XX...X.....XXX...X....X.X......XX...XX...X...X.X....X..X.......X...X..X..X....XXXX.X...X.X..XX.
X...X..XXXX.X....X.X....X...XXXX....X....XXX.X..XXX.....XX.X..X.X..XX..X..XXX..X..XXX..........X....
XXXX..X....X..X..X.XXX...XXX.XXX..X.....X.X....X....XX.XX...XXX.XXX..X..........X..X..XX.X.XX.XX..X.
..XXX..X...XX..XX.X..XX.X...X.XXX...XX.XXX.X.......X..XX.X..XX.....X....X..X.....X.X.XXX.XXXX.....X.
X...X.XXXX.XX..X...X.X...X..X.....XXXXX...X.X.X..X.X..XX.XX.....X.X.X.X.....X.X....XXX..X...........
.XXX....X.......X..X.XX....X...XX.X....XXX.XX.....X.....X...X.X..XXX.XXXX....XX..X......X.XX..X..X.X
..X..XX.X.X.....XX.XX.....X...X..........XXX.X.X..X...XX..X....XX.X..X..XX.X..XXXX.X...X..X....XXXX.
X..X...XXX..X....X..XX.X.XXXXXXX....X..XXXX.....XX.....X..X.X...XX....X.XXXX........XX..............
...XX...X.X...X.....X......X.XX.X.XX.X..XXX...X.XX..X.X.X.X..XXX..XX.X..........X..XX..X...X..X...X.
X....X.....X...........X..X.X.X.XXX.X.X.X.X.XX.XX..........X.X.XXXX.XX..X.X..XXX..X....X..XX....X.X.
...X...XXX.......X....XXXX.X.....XXX.XX...X.XX..X.XX......X.....XX.X...X.XX...X..X.....X....X.......
X.XX...X.XX.XX.....X...XX..XX.XX...X..X....X.XX.....X..X.XXX..X..X.XX..X....XX.X....X..X...X..X.X...
XXX.XXXX.X.XX.....X.X.X.X.XXXX.XXX...XX.X.X.XXX..X.XXXX..X...XXXX....X...XXX.X...X...X....XXX.XX..X.
XXX.X..X......X.X.X...X..X.XX.XXXX..X.....XX.X.XXXX..XX..X.X..XX..XX..XX...XXXX.......X....X.X.X.X..
.....XX...XX.X.......XXX....XXX....X.....XX..XXXX.XXX.....X.......XX...X.X.X..X.X.X.X.XXX.X.X.X.....
X..X........X.X.X....X.X..X.X.XX....XX.X...X...X.X..XXX....XXXX..X....X....X...........X...X.X.XX.X.
X.X.X..X...X.XX.....XX.XX.X..XXXX.X....XXXX.XXX...X....X.XX.XXXX.X...X.X...XX.X..X..X....XX....X.X.X
.....X....X.XXX..XXX.XXX....XX..XXX..X...X..X.X.X..XX....X...X.XX...X..XXX...X...XX.X.....X..X..XXX.
...XX.X....X.X..X.X..XX...X....XXX.....X.XX.X..XX.XX....X.XXXXX....X..X....X...XX.....X...XX.X.XXXX.
XXX.X..X..XX.X....X.....XX....X...XX.X.X....X.X.....XX.X.X.X..X..X.XX...X...X...X...XX..X..XX.X.XXX.
X..X..X...XX..X.......XX.X.XX..X.X.X..X.X.....X..XX..X....X.X...X......X.XXXXX..........X.X..XX.XX..
....X..XX.XX.XX.....X...X.%.....XXX.X.X..XX...XXXXX......X....X.XXXXX.X..XX....X...X..X.XXX...X.XXX.
.X.X...X.XX.XX.XX...X.X..XX........XX.X.X.X.X...X.....X..X....XX..XX..XXXX..XX...X.XX.XX.X.X...XX...
.X.X..XX..X......X...X.X..XX...XXX.X.XXX..X..X........XX.XXXX.X..XX.XX..X...X....X..X...XX....XXX.X.
XX...XX..X.XXXX...X.....X...XX.X.XX..XXXX...X..XX.....X....XX.X.X..X.X...X.XXX.....X......X...X.....
X....XXX...XXXX......X....X....XXX...XX..X.X..XX.XX.....XXX..X....XXXX..X...XXXX.XX.X...X.....XX.X..
X..X..X..XXXX.XX..X.XX.......X..X.X....X..X.X..XX.X.X.XXXXX...XX.X.....XX.XX....X.....X.XX.X..X.....
.X..X..XXX.XXXX..X.X.X..XX...X...XX.X....X...X.XX.XXX.X....XX...X.X..XX..XX.X....X.X.....X..XXX..X..
...X.X...X..XX....XXX..XX..X...XX....XXX....X....XX...XX.X.X..XX.X.X.X......X..X.....XX...X.XX.XX.X.
..X.X..XX.XX....X.X.XX...X.....X..X.XX...X.XX....X...XX..X...XX.XXX......XXX...XXXXX.......XX...X..X
XX.....X..X.X......XXXX.XX....X..XX.X..XX...XX.....X.XX.X.....X...XXXXX..XX....XXXX.XX........X.X...
...X..XX.....XX..XX.XX..X.XXXX...XX.....X.........X.X.XXXX.X.XXX..XX..X.....X.X...X..XXX.X.X.X.XXX.X
X.X.......X.X..X....XX...XXX.X.X...X.XX.XXX......X......X....X..XX.X...X.XXX.XX..X......X..X.XX....X
.XX.......X...X.X.XX..X.XXX.XX.X.X..X...X.X..X.X.....XX.X....X..X.....XXX.....XX.X...XXX.XXXX.XX.X.X
.X.XXX.X..X.X.X........XX.X....X.XXX.X.X...X....X..XX..X......X.X...X.XX.X.X.XX..X.XX..XXX...XX.....
..........X...XX..XX.....XXX.X..XX..XXX.X.XX...X..XXX..XX.XX.....XX.X.X.......XX...X...XX...X.XXXXXX
XX...XXX..XXXX......X.XX...X.X.......X.X..X..XX..X.X.XXX.XX......X...X...XXX..........X.X..X.X.X....
...XX...XX.X.X.XXX.XX...XXX...X......X.......XX...X.XXXX.XX....XX.XXX..X...X..XXX.XX.....XX..X.X.X.X
.X...X..XX..X.........X.X....X.X.......X..X..X.....X...X.XX...X....X....X..X.XXX...X.X.XXX..........
X......X..X.XX.X....XXXXX.X..........X.....XXX.....XX....X..XX.XX....X.X...X....X...XX..X...XXX..XX.
X.X.......X...XX.XXX..X..X...X.X.X....X...X..X.X.X..X..X.X........X.XXXX..X...X....XXXX.....X.X...XX
