..X.X.X...X.XX..XX....XXXX...XXXXXX.XX...X..XXXX..X..XX.XXX..XXX.X.....X...XXXXXX....X..X.X.X.XXXXXX
.......XX..X..X.X.XXXXX...X..XXX.....XX.XX.XX.....X.X...XX..XXX..XXX.XXX..XX.XX.X.XXXXX..X..X.X..X..
..XXX.XX.X..X.....X...........XX.X...X..........X....XX..XX.XX.....XX...X....X.X.XX...........XX....
.XX.....X.XX.....XXXXXX.X..X.X.X...........XXX..X..XXXX..XX.XXXX.XX.....XX....XX..X...XX........X...
.X.....X....XXXXX...X...X.XXX.X....X...X.X.X.X.X.X.XX..X.XX......X.X.X..X.XXXX......XXX....X.X......
.X.X.XX...X.XX...XX.XXX.X.XXXX.X.....X.XXXX....XX.......X..XX.XX...XX.XXXX....XX.X.X.XXX....X..X.XX.
.....XXXX......X...XXX..XXX........XXX...XX.XXXX..X.X.X..X..........X.XXXXX..X..X..XXX.XXX..XX...X..
..XXX.X...XX.X..XX.....X.X......XX....X..XX.......X..X..X.XX..X.X.X.X...X..X..X.XXXX.......XXX....X.
X...XX..X.X.X...XX.XX..XXXX.XXXXX..XXXX.XX.X.......X.X.X.XXX...XX..XXX..X.X.X..X.X..X..X..X.X...X..X
..X....X...X.XX.X..XXX.XXXX..X......XXXX.X..X..XXXX.X.X.XX....X......XXXXX.XX.X...XX......X.XXXX.X.X
XXX.X....X....X..XX.X.X.XXX...X.......XXX.XXX.X...X....X.XXX.....X..X.....X...X.X....XX..X.XXXXXXX.X
......XXXX..X.XX....X.X.X....X.X.X.....X.X......X.X..X...XX..X......X...X.XX...X.X..X.XXX.....X....X
..XXX..XX.........X...XX.XX...X..XXXX..X.......XX.XXX.X..XXX....XX...X.XX...X.X..XXXX...X.XXX.XX.XX.
...X.XX.X.XX.X..XX..X..X.XXXX...X....X.XXX.X.XX..XX.XX.X.X..XX..X.X.X..X...........X....XXX.X.X..XXX
............X...X..X.XXXX....X..XXX.X.X..X.XX.X....X........XXX...X...XX....XX......XXX.X..X.X..X.XX
..XXX.XX.X..X.XXX...XX.X.X.........XX.....X.XX.XXX...X..X..X.X.......XX.......X.XX...XX.....XXX.X.X.
...X...X.....X.XXX...XX....XXXXXX........X....X....XX..X....XX.XX.X.......X.....XXXX.X.XX.....X....X
.X.......XX....X...X..X...X..XXX....X..X..X..X.............X.X......X.X.XXXX..X...XXX.X....XXXXX....
..XX.XX.X.XXX.X....XXXX.X.XX...XX..X.X..XXX...XXX......XXX.X..XX...X.X...XXXXX.X.X.......X.....XX..X
.......X.X..X.XX...X.......XXX.XXXX..XX...X.XX..........X....X...XX......XX.XX.X.....X.X..XX.....X.X
X...X...XX..XX...X..X.X...X.X..X..X.X.XXX...XX.....XX..XXX....XXX.X......XXXX..X.X....XXXXX....XXX..
XXX.......X.X..XXX...X........XX..X.XX..X.....X.X.XX.X..X........XX.XXXX.....X.X.X.X.X..XX.XX..X.X.X
X......XX..X...XXXX.X..XX......X.X.X..X...XXXX..X......X..XX.X.XX..X.X..........X.X.X.XXXX.X.X......
..XX.XX.XXX......XX..X.X.X.X......XX.X.XX.X.XXX.X..........X...XX....X....XXX..X.X...X...X.X.XXX..X.
....X.....XXX......X.X.X...X.......X..............X...X.X.XX....X.X.....XX.X.XX.....X.XXXXX.XX.XXX..
..XX......X....X..X.XX..XX..X.....XXXX..X..X....XX..X...X.X.X...X.X.X....X.XX...X..XX....X.XX.X.X..X
...X...XX.X.X..XXXX.X.X.XX.X.X.X..X...X.....X.......XX.X..X..X...X....X.X......X....XXX.X....XX...X.
XX.X.X..X.X........X.XXXX.X...X.X..XX.......X...X.XX.XX..X....X.XX....X.....XX..XX.X.X.XXXXX....X.X.
XXXX..X..XX....X.X.XXXXXX.X.....X........X.XX.X..X...X.X.X..XXX....X...XX..X...X....X.X....X....X...
XX..X.....X..X.XX..XX....X.X..XX.XX.........XXX...X.X......XXX.X.X....XX..X..X..X...X....X.X.XXX....
..X..X.....XXXXXXX.X..XXXX.X...XX...XX....X....X.XX..X.......XXXX......X..X.XXX..XXX..X.X..XXXX.X...
........XX..X.XX.......X.X.X..X.XXXX..XXXX..XXXXX....X.....XXXX...XX.X....X......XXX.X..X.....X.X.XX
...X.X..XXX....XXX.X..X..X.XX...X.....X.X..X.....XXX.XXX..XXX.X..XX..X...XX.XX..XXX.....X..X.X.XX..X
X.X..X.....X...X.X.X.XX........X..X.XX..X.....X...X.XXX....XX..X....X.XX.X.XX.XXXX.X...X...XX..X...X
....X.XXX.XXX...XXXXX...X..XXXX..X.XX.XXX.XX.X.X....X.XX.X.X.XXX....X.X....XXXXX.XX...X.XXX.....X...
X..XX.X..XXXX........XXX.X.XX..X..XX..X...X.X...X.X..X.X.XX..XX.X..XX...X...XX..X.X..X...X...XX..X..
X.X...X..X..XX.XXX....X.XXX..X...XXXXX...X.X...X..X.XXX..X...X...X..X..XXX.X..XXX..X.XX...X..X....X.
.X...X..XX..X.XX.XX.XXXXXXXX........X.X.X.XXX...XXXXX.XXXXX.X.X.XX..X.......X.X.X....X.X.X...XX..X.X
.XX.X..X...XXX.X...X.X.X...XX..X.XX.......X..X..X..X.X..........XXX.X.X....XXXX..XX..X.XX.XX...X.XXX
...XX..............X.XX..X....XX..X...X...X..XX......X..XX...X.....X..X.X....X..XX..X..XX..XX.......
....XXXXX..X..X.X.X....X..X........XXX.....X....X...XX..XX.XX.XXX..............XXX.XXX.X.X....X.X..X
XXX.X.......X..X...X.X.XXXX.X.XX.X.XXXXX.....XXX....X......XXXXXXX.X.X.X......X...XX.XX....XX.X.XX..
..X.X.X.XXX......XX.X...XX.....X.X...X..XX..X.....X..X.....XXXXX.....X..X...X....XXX......XX...X.X.X
XX...X.XX..XX...XX....X.XX....XX.X..X...XXXXXXX.XXXX.X..XX..X...X.......XX.X..XX..XXX.X.X...XX...X..
..XXXXX.....X...XX..X.X.X...X.X..X..XX....X.XX........X...X.X.X.X............X..XXXX.XXX.X.XX.....X.
.XX.X..XXX.X.....XX.X.XX.XXX......X......XXXX.X..XX...X.....X.X....X.XX..X.X.XXX...X...X...XX.....X.
X....X....XXXXXX.X..X..X...XX..XX.......X....X...XXXX.X.@X....X...XXX...X.X..X.XXXX..X..X..XX..X.X.X
XX..XXX....X..X....XX.XXX....XX........XX...X.X......X.X...X...XX.X...XX.....X.X..X.XXX....XX.X..X.X
X.XX..XX.X...X.XX..X.X.X....X.X....XX.....XXX.XX.X.X......X.XXX.X......XX.XX.......X...X.XX........X
..XXX...X..XX..X.....X......X..XX.......XX.X.........X..XX..X.X....XXX.XX..XXX.X.XXX..X.....X....XXX
X.X.XXXXX.X....XX....X....XXX..X.......X...XXX......X.XX.XXX.....XXXXX..X.....X....X.....X.XXX.X.X..
..XXX..XX..........X...X....X...XX.XX....X..X..XX..X....X.X..X.X.X.X.X....X...X....X.XX.XX.X.XX..XXX
...XXXX...X..XX..X.X...X......X.............X.........X.X.X...X..XXXX.X.......X...XX...X..X.X......X
.XX.XXX..X..X....X....X..X.X.X......X.....X.X..X....X..XXX....X......X.....XX.....XX.X.X...X.XX.X...
..X..X...XX..XX.X...X..X..XXX.XX..XX.X.XX.X..XXX..XX.....X.XXXX...XXXX.X.X....X.X....X....XXX..XXX..
.X..X..X.XX.X....X.XXXX....XXX..XX.XXXX.XXXX.X.X.X..X....X.X..X.X..X..XX.X......X..X.X...XX......XXX
X....XXXXXX...XX.X.XXX......X..XX.X...X.X....X...XX.XX......X.....XXX....X...X........XXXX..X..XX.XX
....XX..X.X......X.X.X.....X..XX.X.....XX...X.X..XXXXX.XXXX...X..X..X...........XXXX.X...XX..X..X.XX
.X.....XX..XX.X......XXX.XXX..X..X.XXX..X.........X....X..XXX.X.....XX...XXX..X..X....X..X....XX..X.
X.X..XXXX.X.X...X..XX...XXXX....XXX...X..X..X...X.X..X......XXXX..X.X...X..XXX..X..X..XX..........X.
...XX.X..XX....X....XX....X.X.X..X.XXX.X.XX.X...XX...X.XX.XX..X....X..X.....XX...XX.X..X.X.X.X.....X
..X..XXXX.......X.XXX.....X........X..X.X..XX.....XXXXXXXXXX..X...X...X.XXX...X......X..XX...XX..X..
....X.XXXXX.XXX..X.X.X....XX.....X..X..XX.XXXX...XX.X.X........X.......X........X........X.XX.XX.XX.
.X....XXX..X.X..X.X.XX.XX.....X.....XX.X...XXXXX..X.XX.X.....X.....X........XXX.X.XXXXX..X..X.X.XX..
.X..X......X...X...XX..XX..X.XX.X..X.X.XX...X.X...XX..XXX.X.X.XXX.X...XXX.X.X.......XXX.X...X.X..XXX
.XX.XX..XXX.X...XX.........X.XX...X..XXXX..X........X..X..XX...X.....X.X...XXX..X.X......X..X.XX..X.
...X.....XX..X.XXX..X...XX.X.XX..X.X.X.X.X......XXX..XX.X..XX....X.X...X.X........X...X....XX...XX.X
.X..X..XXXX..X..XXXX.....XXX..X...XX..X..X..X.XXX...X........X.XX..X.X....X.X....X....X.X.....X...XX
..X..XXXX.........X..XX.X....X...XXXX.XX....X..XXX.X.X..XX......X...XX..XXX.X..X.X.X....X......X..XX
.X...XX..XX...........XX..............X.X..X.X.....XX..X.....XX.XXX.X...XX...X......X.X...X...X.XX..
.XX.XX...X..X....XXX..X...XX.X...XXX.XX.X.XXXX.....XX....X...XXX.XX.X.X.X..X..XXXX..X.XX....X...X.XX
.X..XX.....XX.X.XXX.....XXX.XX.X..X.X.X....X.XX.X.....XX..X.XXXX...XXXX....X.XXXX...X...X..XX......X
.....X...X.XXX..X.X.X.X..X..XX.X..X.X.XX..........X..X...X.X.X...X......XX.XX..XXX......X.X.X.X.....
.XXX.XX...X.X......X.XX.....X.XX...XX.X...X.X.XX...X..X...X.X..X.X.XXX....X.XXXX...XX..XX..X.X.XX...
XX.XXX.X.X.X.X...X.X..X....X......X.X...X..X...XXXX......X.XXX.XX..XX.X..X....X...X...X.X.X.X.X.XXX.
X..X....X..XX....X...X....X.....X...X....X.X..X.X.XXXXXX.X..X...X...X...X....X.XX.X..X.XXX.X..XX...X
XXX...X..XX....XX.X.X..X....XX...X..X.X.X...XX..X....XX.X.XXX....XX.X........X.....XX.X.....XX..X.X.
..X.....XXX..XX.X..XXXX.X.X..XX.....X.X...X......XX..X..X......XXX...XX............XXXX.XX..X.XXX..X
.X.....XX......X....X.XX..XX.XX.X.X.X.XXXXX.X.X...XX...X..XX.....X..X.X..X.X.........X..............
..XX..XX.X....XX...X.X.XX.XX.....XXXX.X.X.XX...X..X......X..X....XXX.X.X.X.....X.XX...XXXXX.....X..X
X.XXX..XX....XX..X.XXX...........X..X.XX.......XXXX.XX..X.X..XXXXXX.X.X.X...X.X..XXX..X.X.XX.X.X.X.X
.X.......X..XX.X..X....X....X.X...X.X.XX..X....XXX..X...X.X.....XXXX..XXX...X.X......X...X..XX....X.
XXXX.X.X...XXXXXXXX..XX.X.....X...XX...X....X..XXX...X......XXX.X.X..XX.X.....XXXX...XXXX...XXX..XXX
..X.X....XXX.XX..X...X.X.X.XXX.X..X.........X.X..XXX.X.X.XXXXXX.X.XX.X.XX.XX.XX..XX...XX.X...XX..X.X
.X.......XXX...X...X......X...X..XX.X..X....XXX.X..X.X..X..XX..X....X.X.X....XX...X.XX.........XX...
.X..X.XXXX..XX.X...XX.XX.XXX...XX.XX.XX.X...X.XX.X...XXX.X....X...XX...XX...X.XX..XXX.X....X......X.
..X.X.X..X.XXX...X.....XX....XX..XXXX..XX..XX.XX..X..X..XX..XXX...X...XX....X...X..XXX.X.XX.XX...XXX
......X.......XXXX.XX...XXX..XX.X..X..........XXXXX...X.XX....X.XX..X.......X..XXXX...X..XX..XX..XX.
....X....X.....X.X....X..XX...X..X.XX.X..XX..X....XXX.X..XXX.......X....X...XXX.....XX..X.....X...X.
.X.X......XX.....XXX...XXX...X.XXX...XX.XX..X.X.XXXXX..XX..X...XX....X.XX....XXX.XX..XX..X....XX.X..
.%.X.XX.X..X....X...X.....XX..X....XX...XX....X..XX..X..X.XX.XXX...X...X.XX....X.X.X.X......X.....X.
.X.XX...XXXX.X....XX..X.X..XX.....XX...X...XX..XXX....X..X..XX...XXXX.XXX..XX.X..X.X.......XX..X..XX
XX..X.X.XX..........X.X....X...XX.XX.X.X............X.XXXX...X.X.XXX.XXX.X....XX.XXX..XX....XX.XX.XX
X...X.X...X...XX..X.XX...X.X.X.....X...X.X.....X.X.X...XX..X..XX...X..XXX.XXX..X.X.X.......X...X.X..
XXX.XX...X...X.......XXXXXXXX.X.X...X..XX........XX...X...XXX....XXX....XX..X...X....XX..XX..X.X.X..
X....X.X......X.XX...X.X..X......XXX.....X.X.X.....XXX....XXX.X..X.XX....X..X...X.X....X....X......X
X.X.X.....X.X.X.X..XX.XX...XX...X........X..XXX..X.........XX.XXXX....X........X...X.X...X.XX...XX..
.....X.X.XXX.X....X..X..X.X.XX.X.X..XXX.X.X.XX....XX..XXX...XX..XX..XX..XX...X.XX.X......XXX.....X.X
.XX......XX..XX..XX.X.X.X.X......XXXX.XX..XXX..X....X.X..XX...XXXXXX...X...XX....XXXX....X......X.X.
.X.X....X.XXX.X....XX..XX..XX..XX...........XX..XXXX.X.XX.XX......XX..X..XX.X.....X..............XXX
