.X..X.....X....X......X..X..XX..X..XX.XXXXX.X..X..XXX.X.XX......X.XXX.X..XXXXXX...XX..X.XX....XX.X..
.....XXX.XXXX......X........X...X..XX...X..X.....XX...XXX..XXX...X.XX.X...X..X.......XX.........X.X.
.....XX..X.XX.XX.....X......X....XX.X...XX.XXX..........X..X.XXXX..XXXXXX....XX...X..X..X.X.XXX...X.
.X.XXXXX......XX..X...X....X......XX...XX...XX.X.X.....X.X..X...X.X....X.X....XXX......X..X.XXXX.X..
.........XX.X.XX.X....X.X..XXXXX...XXX..X..........X.X.XXXX....XXX.........X..XX..X.XX..XX.X.XX..XX.
XXXX.XXX..XXX..XXX..X.XX..X...XX...X.XX.XXX.XX.X.X.X.X....X.X.....XXX.X.X..X........XX...X...X.X...X
XXX.XX..X.X.X.XXX...X.X...XX.......X.X..XX.XX....XXXXXX.XXXXXX....X...XX.X.......X..X.XX......XX...X
....X....XX...X..XX....XXXX....X.X.XXX.X...XX....X..X.X.X.X..X....X.....XXXX..X..XX.X..X..........X.
XX.X.X..XX.X.X.X....XX...X...X.........X.X.XXXX......X..X.XX.X....XX...X.X..X...X..XX...X.XX.X.X..XX
XX...X..XX...XXX.XX.XXX.X....X.XX.......X....X..X..XX....X.X..XX........XXX..X...X...X.X...XXX...XXX
....XX.XX.X.X....XXXX...X.X..X...XX.XX......X...XXXXXX..X..X.XX.X..XXXXXX..XXX...X..X...XXXX..X.X.X.
...X...XX.X.XXX..X...X..X.X.XX..X.X.XX....X...XXXXX....X..XXX..XXX...X.XXX.....XXXXX..X.X.X.X...X..X
X...X.....X.....XXX.....XXXXXX.X.X...XXX..X..X.....XX.XX.X..X.......XX..XX.X..XXX....XXX....X.X...X.
.X.....X.......X.XXX.X.XXXX.X....XXX.XX......X..XXX.XX..X.XXXX.XX.X..XX...........X..X.XXXXX...X..X.
....XX........X.X...X.....X..XX.XX..X.X.X..X.....X..X..X..X..XX.X..XXX.XX..X....X.XX.......X....X..X
X.........X.....XXXX..XX.X.X....XX.....XX....XXX....XXX.X..XX.X.....XX..XX.XX.X.XXX.X...XXX.XXX....X
..X.X..X..X..XXX..XXX..XXXX..X..XX.X.....XXXX.X..X...X..X...XX.X.X..XXX..........X..XXX.X.XX.X..XXXX
.X.XX..X.XXXXXXXX.X..XX..X....X.XX......X.X....X.X.XX..X...........XX..X...X....X.XX.X.......X.X.XXX
X..X.X..X....X...X..XX....X..X.XX.....X.X.XX..XX....X.XXX..XX..X.XXX.X..XXX.X.X.....X.X...X.X.X..X.X
.XX....X....X..X....XXX.XX....XX.X..XX.X.XX.X....X.XX....X.X....X......X..XX.X.....X.XXXX.X.....XX..
...XXX.X.X.X.X...X....XXXX.X...........X....XX.XX.X..X....XX..X.X.....X..XXXX......XX.XXXX..XXXX..XX
..X..XX..X.....XX............XXX.X.X.XXX....XX...XXXX..X..X.......X.XXXXX.XX......X...X..X.....X..XX
X.XXXX.XX...X.X...X...X.X..X.X.X......X.X...X......XX..XXXX..XX.....XXX.X...X......XXXXX.X.X..X.XX.X
..X..XX.X...X.XX..XX..X...X..XXX..X...X...XXXX..XXX....XX..X.XXX...X.......X...X....X...............
X.....X.X.X.X.X...X.X.XXX..X.XX.XXXX........X...X.XX.X..X...XX.....X...X.....XX.....XX.X...X.X..X..X
X...X......XX......X..XX..X.XX.X..XX.X...X.X...XXX.X.....XX.X.X.XX.X...X....X..XXXX.XX.X.....XX.X.XX
XXX..X...X.X..XX......XXX.X...X....X....X..XX......X..@X.XXX..X..X.XX.X..X...XXX...X...X...XX.X..X..
.....X..X.XX..X.X.X..X.XX........XX.X.X.X.X...X.X...XXXX.............XX....X.XX..X....XXX...XXX.XXX.
XXX...XX....X.X.X....X.X.X.XXXX..X.X.XXX.X.X.X.XX.XX..X.XXX..XX..X..X.XX.....XX....XXX..X..X...X.XX.
X.X..XX..X.......X..X...X....X.......X..X....X...XX.X..X.X.X.X.......XX...XX.....X...X....X....X.X.X
..XX.X..XXXXX.X..XX......X........X..XXX.XXX...X.X.XXXX.X.XX..X.XX.X.X....XX.XXXX.X.X..X.X...X.XX.X.
X..XX..X..XXX....X.XXX.X....XXXXX..XXXX..X.X..XX.....XX....X.X..X...X....XXXXX....XX.XX.XXX.X..X.X.X
....X.X.X..X.XX...X......X.XX.XX.X.XX.XXXXX.X..X.XXX.X....XX.X..XX.X.X.X........X.X...XX...XXXX..X.X
X.XX.XXX...XXX.....X......X.XXXXX..X.XXX...XX..X.XX.X..X.X......XX...X.X.X..XX..XX...........X.X..X.
.X....X.X.X.X...X....XXX.X.X....XX...X.......XXXX...X.X.XX.X..X...XXX..X.XX.....X.XX.X.........X.X.X
.X...X...X.....X..X.XXX..XXXX....X...X...X.X.X.XXX.XX.X..X.XXXX...XX...X.XXXXXXXXXXX.X..XX..X.X....X
XX.X.XX.X.XX...XX.XX.....XX..X.X...X.X....XXX...X.X..XX.XX..X.XXX..XX..X.XXX.XXXXXX.X.X.......X.XX.X
..XXX...X.XXX.X.X.X...X....XXX....X..X.XXX.......XXX.X..X.....X.XXXXX........X..XX.....XX.X........X
.X.X....XXX.X..XXXX..X.X.XXXX.X...XX..X.XXX.XXX.XXX..X.XXXX...X.X.X.....XX.XX..X...X.X....X.X..XXX.X
.X...X.X.XX.X.X.X..........XXX......X.X.XXXX.XX...X...XXXXX....X...X..XXX.XX.X..XX....XX..XX....X..X
.....X..X.X.....X....XX..X....X..XXXX..XX..XXX..XX..XX.X...X..XX...XX.X..X......X.X...X.XX........X.
XXX..X..XXX......XXX.X........XXXXXX.X........X...X...X..X.X.X.XX.XXXXX.....X.....XX...X.X..XX.XX..X
...XXXXX....X.X......X.X.X...X.XX.X..X.X.X....X.X.XX.X.X..XX...X..XXX...XXXX......XX..X..X.X.XX.X...
.XXXX...XX...XX..X.X.X..X.X..X......XXXX..X....XX.X..X...XX..XXX........X.X..X..XX....X..XX.X.X....X
X.XX.........X.X..X.X..X.XX.XXX.XXX.XXX.X.......XX....XXX...XX.X.X.XXX.X..........XX...XXX.XX...X.XX
..X...X.XX..X.X......X.X..X...XX......X.XX....XX..XX..XXX.X.XX..X..X.X.X.X..X......X.XXX.X.XXX...X.X
X..XX.X....X.X.XX...XX.....X.X..X.....X.X...XXXXX.X.XX.......X..X.XX.....XX.XX.X..X.X.XXX.X..XXX...X
...X...XXX.XXX.XX....XX...X.X....X..X.X............X..X.....X..X.X....X..XXX.X...XXXXX.X.XXX...XX.XX
X......X.X...X.....X.XXXX...X..XX.....X.X.....X.X...XX.X....X.X..XXX.........XX...X..XXXX.....X.X.X.
...X......XX...XX...XX.XXX.X...X.X.X...X.X.XX.X..X....XXX..XX..XX.....X.X.X.XX.XXXX..X....XXX..XXX..
.XXXXX..X..XX...X...XX...XX..XX.XXXXX..XX.X...XX...X.......X..X.X.X.X......X....X....X..X....XX.XX..
....X...XXX...X.X..XXX.X.XXX.X.....X..X.X...X..X.......X.X.X...X.X.....X..........X..X.XX.X....X...X
.X.X.X.....XXXXXX...XXX....X...XXXXXX..X....XXX..XXX...XXXX....X...XXXX..X..X......X.XXX..XXXX.XX..X
....X..X..X........X...X.X......X.X...X.XX.XX..X...XXX..X.XX.X..XXX..X..X...X........XXXX.XX..XXX...
..XX..XXXX..XXXXX..X.XXXX.....X..X..X...XX........XX..XX..XX.X..X...XX.XXX...X...XX......X..XX....X.
....X....XX.X........X.XX..XX.XXX..X..X.X..XXXX.X..........X.XXX..X.........XX.XX.X.X..XXX..X.X..X..
XXX....X.X..XXX.X.XX....X.X.......X...X....XXX...X.XXXXX............X.XX..XX....XXX.XX..X..XX.XXX..X
X.XX........XX.XX..XXXX...X....XX.X.XXXX.X..X..XX....XX.......X.X.X.XXX...XXX.X.X.X......X....XX.XX.
.X.......X.X..X....X....XX..X.X.......XX..XX..XX.XXX.XX..X...XX..XXX..X.XXX..XXX.X...X..X..X....X.X.
XX.XXXXX...X.X.....X...XXX.X..X..X...X.X...X..XXX...X....X....XX.X...X.XX...X.XXX....XX.XXX.XXX..X..
X....XX..XX..X...X.....XXX..X.X..X...X.............X.XX..X.....X..X..XXX.X.X.X.X....X...XXX.X...XX.X
.XXXX....X.X...X..X........X.XXXX....X.X.....X..X...X.X.XX...XXX.X.XX..X...X.XX.X..X....X.XXX..X..X.
X...XXX.....XX.X.X..X.X....XXXX.XX...X..XXXXX.XX.X.X.X...XX.X.XX.X..X.X.....XX......X...X....XX.....
.X.......XXX.XXX....X.X.XXX.X.XXXXX.X..XX....X..XX..X......X........X.X....X..X..XXXXX.XX.X...XXX...
XXXXX..X..XX.....X...X..XX...X.......X.....X..X....X.X...X.....X.XX...X......XX..X.X...X........X.X.
.X...XX.....X.......X.XX....X.XX.XX.X......X.XXX...X.X..X...XXX..X..XXX..X........XX...X.X...XXX..X.
X......X.XXX.X....X...XX.X.X.X.X..XXX.XX..X.X.XX.X.X...X..X..X........XXXX.X..X.X.XX.X..XXX..X....XX
....X....X.....X..XX.......X..XX.X.X.....XXX...X.XX.....X...XX..XX.....X..X..XX......XXX....X.X.XX.X
..X.X.X..X.X.X.X.XX.X.XX.XX...XX..XXX..XXX.X........X....XX..XXX.....X..X.X.X......XX..XXXXX.......X
..X.XXX..XX.XX.....X.X...........X...X.XXX.....XX....XX.X......XX..X.....XX..XXX..X.X...X..X...X....
..X...X.X...X...X...X....X.XX...XX.X...X.X.X.....X.....XXXX.XX..X.XX.X.XX.X..XXXX.X..X..XXX.X..X..XX
XX...X..X..X...XX...X...X.XXX...X....X.XX...X.XX..X.X.X.X..X.X..XXXX...X..X....XX.XX..XX..X......X..
.XX..X.XX.X...XX..X...X.XX...X.X.............X.X.XXXX.XXX.XX.X..X....XX..XXXXXXX.....X...X...X.....X
XX..X....X....X......X.......XX.X.X.X.X.XX.X..XXX.X.X.X.X..X.X...X.......X......X..X..XXX......X...X
X.X.XX.XXXX....X.XXX.X..X..XX.X..XX.X..XX.X.XX...XX.XX.X.XXXXX.X....XX...X....X.X.XXX.X....XX....X..
..XXX..X....XX.X.X...X.XX...X.X......X...XXXXXXX..XX...XX.....X..XXX..X..XX.X..X...X.XXX...XX.......
.X......X....XX.XX.X.XXX..X..X.X...X..X...X..XX.X....XXXXXX...XXX...X...X...X...X..XX...X....XX.XX..
..X....XX.XX.X.X.XX.XXX.........X....XXX...X.........XX.X.X...XXX.X.XX.XX..X..X....X.X..XXXXX......X
..X..X.XX.X....X....X.X.....XXXX......X.X..XX..XX.X..XX...XX.XX.XXX.XXX.XX.X.X....X.XXX.X.XXXX.X....
...X.X.....X.X..XX....XX.XX.....XX.X..XX...X....X...X....X.XX..X..........X.XX.X.X.XXX........X.X..X
...X...X...X.X.......X...XXX.X.XX.X..X......X........XX..XX.X..X.XX....X...XX....X.XX.X.....X.XX.X.X
.XXXX..XXX....X.XXX.XXX..X..X...XX.X.X..XX.X..XX...XXX...XX......X..X............X.X.......XX...XX..
..X..XXX.X.X..X.X..XX.X.X..X....X..XX...X.........X.XX.XX..X.X..XXX...X..X......X.X..X.X........XXX.
.......XX.XX..X..X.XX.XX..XX...X.XX.XXXX..XX...X...X..XX.XX..X..X.X.X.X.X.........XXX.XX..X.X...X..X
X..X.XX.XX..X....XX....X.X..X.XXXXX.X.X.XX.XX..X..XX........XXXX..XXXX.....XXX.X.XXX.XXX...X........
.X.........X....XX.X.XXX..X....X.X..XX.XXXX...X.XX.X..XX.......X.X..XXX.X.X..XX...X.X.X...X...X..XX.
.XX...X.XXX..XXX..X.XXX...X.XX.X..X.....XXXX.X...X.%.XX......XX...........X....X..X.X.XX....XX...XX.
..X.....X...X...X.X..X.X.X.XX...XX...XXX.X..X..X...X.X.XX..X.X..X...XX..XXXXXX.XXX.XXXX...X......XXX
X......XX..X...X..X....X..XX.......XX.XXXXX.X.....X..XXXX.XXX.XXX..X.XXXX..X..XX..XX.X.XX...X.....X.
...X..X...X.X.......X.X.X..X...X.........X...X.......XXXXXX...XXX..XX.XX.X.XXX.XX....XX.X.....X.X...
XX.X.XX.X......X....X..X......X...X...XXX...XX.X.X.X.X..X..X....X..X...X.....XXX.X...X......XX.X.X..
XXX.X....X.X.X....X.XXXX..XXX.XXXXX...X.X..X.X..X...XXX............X.XX.XXXXXXX.X.X.XX.X.X...X...XX.
XX.X.X..X.....X.....XX..XX.XX.......XX.XX..XX..X...XX.X.X..X..X..X...X.XX.....XX.X...X..X.....X.XX..
.XX.XX..XXXX..XX.X.XX..........XXXXX.X..XXX...X..X...XX.XX.X.......X...........X....XX.....X...XX...
..X..X.XX...X.X.XX...XXXX......X...X.XX.X..X.X.XX......X...X..X....XXX.XX.....X..X....X........XXXXX
X......XX.XXXXX..X...X.XXXXXX..XX.X..X..XXXX.XXXX.X.XX..XX.....X..X....X..XX....X....X..XXXX..X.....
XXX..XX..XXX......XX.XX.X..X....XX..X......X...X....XXX.X.XX.....X....XX..X.XX.XXX....X.......X..X.X
X.....XX.X...X....X.XXX...X.XX.....X.X......X.X.X......X..XX.XX.X........XXX..X.......XXX...X...XXXX
.....X...XXXXX........X.XX..X.XX..XX.XX.....X..XXXX.X..XXXX.....X.XXXX...X.XXXXXXX..XX...X.X.X.XX.X.
X...XXX.XX...X......X.XX...X...X..XXX...XXX.X.......X.....X...X.XX...XX.XX...X....XX.XX.XXXXXX......
