X.X...X.....XX...X.X..XXX.X...X......X...X..X...X.XXX.X.....X..X.X..X.XX.X.....XX..XX.........XX.X.X
...XXXX.X.XX..X.XXXX.X..XX.....X.....X.X.XX...X..XX...XXX.XX...XX.X.X...XXX.X............XXX...XXX..
..XXX...X.X...XX...X.X.X.XX.XXXXX........X.XX......X...X.XXX.X.X..X....XX.X.X....X...XXXXX..X...XX.X
.....XXX.......X..XX.X....XXX..X..X...XX..X..XXX.X.X.XX..X.......XXX..XX..X...XXXX.X...X.XX.X.XXX.X.
.X..X.X..XX.XXXXX...X.....X....X.XX.X..XXX..XXX....X..XX.........X.XXXXX...X.X.X..X.......XXX.XX..X.
...X.X...X..X.XXX.X..X....X.X.X.....X.X....XXX...XX..X.X.X.X..X...X.....X........X....XX.X.X.XX.....
......X...X......XXX.X.....XX....XX.XX...X.......XXX....XX.X.XX.........XX..X..X..X...X.XXX.X.....X.
....XX.X.XX...XXXXX...X.X...X.XXXXXX.X....X..X.X..X..X..X...XXXXX.X..XX.......X..X....X......XXXX.XX
.....X...X.XXX...X....X.XX.X..X.XX..X...XX..X.X...XX...........XXX.X.XX.X.X..XX.......X..XXXXXX...X.
X....X..............XX.........XX..X...X.....X...X..........XXXX....XXX.XX..XX.XX..X.XX.X.X..XX...X.
..X.XX...X..X...XX...X....X.X..X..X......X....X..X........XX...X...X...XX...XX......XX..X....X.XX...
....X...X....XX..X...X...XX...X....XX.X...XXX.X.X..XX..X....X..XX..XX......X.XXX.....XX...XX..X.X...
XXX...X.X..X.X.X....X..X....X..X...XX..X..X...X..X...XX.XXX.X....XXX.X...X....X.X.X.XXXX..X.XX...X..
XX.XX.XX.X.X..X........XXXX..XX.XXX........X.X.XX.X.XXX.X.XX....X..X.XXX.X...X.XX...X....XXX.X..X...
XXX..X.X.X..........X........X.X.X....X......X.....X..X...X...XX.XX......X....XXX..X.X.X.X..X.XX....
X..X.X...X..XXXXXX..XX....X.X.X.X....X...X..XX.XX.XX..XX.X...XXX.X......X.......XX..X.XXXXX.X..XX..X
..X...X...XX.XX....XXX.XXXXX..XXX..X..X..X.X.XXXXXXX.XX%X..XX....XXX..X........X....X.X.X.XXXX..X...
......X..X....X..X...X.X.X..X.X...XXX..XX.X.X.....XX....XX..XX.XXXX..X.X..XX...XXX.X...X.X..........
..XX...X...X....X.XX........XX.XX.X..X..X..XX.........X..XXX.X....X......X........X...X.X.XX...X..X.
X.X.X....XX..X..X..X...XXX.X......X...X...X.XX.....XX..X.X.X.X.XX....XX.X...XX.........X.XXX....X...
...X..XX.X.XX..XX.X..X.XX..X.X.XXX..X.XX....XXX.....XXX........X.....XX.XXX..X.X..X...X.......XX..XX
..X.X...X..X....X....X...X..XXXX..XXX.XX..X..XXX....X......XXXX.X....X...X.X....X...X..X...X..X.XX.X
.XX.X.X......XX....XX....X..XXX.X....X..X....X.X.XX.X......X.X.XX.X....XX..X.....XX.XX..XXX...X..X..
X......X.X....XX..XX..X........XXX.XX..X...XX.XXXX.....X.X.XXX.X.X....XX.XXXXXX......XX....XXX.....X
...X........X....X.......XXXX.X....X.X..XX..X..XXXXX.XX..XX....XXXX..X.X..XX....X..X.X..XX.X.XX....X
.X.X..XXX.XX.XXX.X...XX...X....XX...XX.XXX.XXX....X..XX........X.X.X.X..XXX...X.....XXXX.XX.X.......
.XXXXXX.XXX..X...X..X.XXX..X........XXXX.........XXXXX.XXX.XXX.XX.X..X..X.....X.XXX..X...XX.X.XXXX..
...X....X..XX.XX...X........XX..XXXXX.XX..X...X......X........X.X.XXX.X..XXX.X....X..XX..X....X...X.
..X..XXX.X........X.XX.XXXX.X..XX.X....X..X...XX.XXXX...X.XXX..X..XX...X.XX.....X..XX.XX.X..XX..X.XX
.....X..X..X...X...XXX.X.XX..X..XXXXXX..X..........XX....X..X.X....X....XX.X.XX.XXX.X..XXX...X.....X
.....X...XX.XX....XX..X.XX..XX......X.X............XXX..X.XXX...XX.X.X.XXXX.....XXXX..XX.X.XX.X.X...
.X.XXXX.X.X..X.X.XX.X....XX.XX..X.X.....X.....XXXX....X....X....XXX....XXX.X...XXXXX..X.......XXXX..
X.X.X.....XX...XX.X..X...X...XX..XXX..XX.X.X.XX.X.....X....X..X.X.X.X..X.X.X.XX...XXX.XXX.X..X......
.X.X.XX.XX.X.X...X...X.....XXX......XX.XX.X...X.X..XXX....X.XX.X...........X....X.X.XXXXX....X......
.....XX.XX........X....XX..X...XX......X.X...X.....X...X..X.XXX.....XX.X.....X.......X...XXXX.XX.X.X
XX.X.XX..XX.....X.XX..XXXXXX....X.XX......XX...XXXX.X...XX..X....XXXX...X.XX..X........XXX......XX..
...XX.X...X....X.X...X.XXXXX.X.XX..X...X.XX......X.X......X.X...XX...X...X.....X.......X....X..X...X
....X.XXX.X..X..X.X.X.....XXXX..X.X.X...X.....X...X..X.XXX....XXX.XX....XX..XX.X..X..X.X.XXX.X..X.X.
..X.XXXXX......X...X.........X..............X...XX...XX....X........X..XX.XX..X....X...XX....XX.....
X.X.XX.XX.XX.X..XX.XXX...X..XX.XXX...X...X.X..XX..X....X.XXXX..XXX..X.X........X....X...X.X.X.XX.X..
.X.X.XX.X.....X.X....X........XXX.X..XX.X.....X..X..X.X..X.X.X.....X.....X..XX.XXX.XX.X..X.X.....X..
X...XX...XXX.....XXXXX...XX...XXXX.XXXX............X.X...XXX..X.X.XXXXX..X.X.......X..X..XX.XX.X....
..XX.XXX....X..X..X....X.X....X..X..X.XX.....XXXX.X..XX.X....X..X...X..X....XX..X...X.X.X.X.X....X..
.........X..X.....XXX.X..X.X.XXXX.......XXX.....X...X.X.....XX...X...XX.X......X....X..XX..XX.X.XXX.
X.X.X.....XX....X.X....XX.XX..X.X..X.XXX..X..X..X.....X...XXX..XX.XX...XXX.XXXXX.XX.X....X.X..X.XXXX
..X..X.X.....XX.XXX..X........X...X.XXX.X....X.XXXXXXX.X.XX.XXXX..X...X..X...X.X....X..X....XXX.XXX.
X..........XX..X.X........X..X.X...X...X.....XX.XX..X........XXX....X.XX..X...XX.X..XX..X...........
X....XX....XXXXX.X..X.....XX........X..XXX...........X..XXX.X..XX..XXX.X.XX.....X.XX..X...XX.X...XXX
........X.X.XXXXX...X.....X....X.XX.X...X.X.XXX....XX....X...X.......X..X.XX.XXX..X.X...XX..X.X...X.
.XXXX.....XX..X.XXX.X...X.X.....X...X..XXX...X...X.XXXXX...X.....XX.....XX.XX....XX..X.XXXXXX...XXX.
XX.X....XXXX..X..XX.X..X....XX........X.X.....X....X....X.XXX.X.XXX..X.XX.XX.X......XX....X.X.XX...X
....XXXX...XX.X..X....X..XX.X.X.XXX..X.X..XXXXX..X....X.....X.X...X...XX.X.X..XX...X.X..X.X.XX..X...
X.X..X.....XX.....XX.X..X.X..XXX.XXX..XXXX..X..XX.X.X..X.XXX..XX.X...XX.XXX.X.....XX.X..XX..X.X.X...
...XXX.X.....X.X....XX.X...XX.X.XX..XX...XXX.X...XXX.X..X....X.XXXXX....X.X.XX..X....XX....X.XXX....
...XX...X..X.X.X.XX.X.X..........XX....XX..X.......XX.XXXX.....XX.X.X.X.X.X.XX.XX..XX...X.XX....X..X
..XXXXX.....X.X....X.X..XXX..X.XX.XXX...X..X.XXXX..X....XX....XX...XX.X.XX.XX......X.X...X.X.X.X...X
X.XX....X.XX....XX...XX.....XXX......X..X...XX.......X...X....X....X..X.XX.....X.......XXX.X.XX.X...
.X.XXX.........XX.X.XX..X...XXX..........XXXX..X.X...XX.X..X....X.........X..X..X......XX...X....X..
X.X.XX.X....X....XXXX..X..XX....X.X.XXX...X...XX..X..XX.X..XXX..XX.XX.X..X..X.X..X..X.X.X.XX..XXXXX.
XX.X.....XX...XX.X........X.........X.XX...XXX......X.X......X.X..X.X..XX..XXXXX.XXX...X.X...X...X..
XX....X.X.X...XX..X.XX....X...X.X.XXXXX...X..XX.X......XX.XXXXX.....X...X.X..XXX.X....X....X.X.....X
..X.....X..XX....X.X.XX.X....X...XX.X...X..X..XXXX.X.X.XX.XXX...X............X..XX..XX..XX..X.X.XX..
..XX....XX......X.X..X...XXX...X.X.XX.X...X......XX..X...X.XXXXX.X..X.XX.X....X..X..X..XXX.......X..
..XX..X..XXX..X.X...X.XX..XXX.X.X.X....X....X..X.XX..X.X....X.X.X......XXXX...XX..X.....X.X.XX..X.X.
..X.X..XXX...X.XX.X...X...XX.X.X..X.XX.X.XXX.X.XX.XXX..XX......XX..XX.X..XX..XX.X.X.XX......X...XXXX
...........XX.....X..X....X..XX.X..XXXX..XXXX.XXXX.X..X.....X...X..X.X.X.....XXXXXX.X.X.X..X..X.X..X
X..X.XXX.XX..X......XXX..XXX...XX......XX....X.........X.XX..XX.X..X...X..XX.X....X.....XX..........
.X.....X....XXXX...XX..X...X....X...X...X.X.XXX...X.XX.XXX.......X...XXXX.X..X..X..XXX..X........XX.
..X.....XX..........X.XX...X....XXX..X.XX......X.X.....X.X..XX..X..X...X..X..X..XX.X..XXX....XXXX...
X.....XX.X..X.....X.X.X.X..XX.X.X..XX.X.X.X..X.X...XXX...X.X..X...XXX.X.......XXXXX.X.X....XX....X.X
...XX.X....X..XX.XX.X.XXX.....X....X.X.XXX..XXXX..X.....XXX.XX........XX.XX.XX.X......XXXXX.XXX...X.
...XXXX...X..X.X...XXX...@XXXXX.X.X..XXX.X...X..X.....XX..X......X.X..........X.X...XX.....X.X.XXXX.
.X..X.X..X..X..XXX.X.X...X.....XXX.X.XXXXXXXXXX..X..X.XX..XX..X.X........X.X.XX.XX..X...XX.X...X...X
....XXXXX...X.XXXX...X..XX.XX.X..XX....X.X.X..X.XXX.X...X..X.XXX.XXXX...X..X.XX......X...X.....X...X
X..X.....X.....XX.X.X....XXX.XX..X....X.X.X....XXX..X.XX.X.XXX.X.XX..X.XXX.XX..........XXXXX..X.X.X.
.XXX..X.XX.XXX.X.....XX....X.XX....X..X..XX...X..XX..XX......XX.X.XX...X..X..X...X...X.XX.XX.XXX.X..
XXX....XXXX.XX.X...X..X..XX.XX..XX....XX.XX.X.X......XX..X.X..X...X..X..X.....XX......XX............
..X.XXX.XX.X..X..XXX..XX.XX....XX.X.X.......XX...X...XX....X..XXXXXXXX.XX.....XX.XXX.X.XX.XX.XXXX..X
..XX..XX.X...XXXX..X.XXX.X...........XXX...X..XX.XX.X.X...XX...XXX...X..XXX...XXXX....X...XXX..XXX..
...X....XX.X...X..X.XX..XXXXX..XX..XX....X...XXXX..X.....X.X...XX.X...XXXX.X.XX..XX...XX..XX.....XX.
X..........X.XX....X.XXX.X.......X.X...XX.....X....XXX.......XX..XX..XXX...X.X.XX......X.XX.XXX.XXX.
.....XX.X.XX.XX..X.X.......X.X..X..XXX..X.X..XXX.....X.XX..X.XX..X.X..X.XXX..XX...X.X..XX.X.......XX
.....XX...XX.X.XXX...X..XX.X..XX.XXX..XXX.XX.X..X.XX.X...X.....X.X..XXXXX.XX...X.....XXXX.XX.X.XX..X
...X.X.....XX...X.X...X....X...X......X.X...X.X..X..XX...X..........XX.XX...X.XXX..X.......X..XXXX.X
....X.X.X...XX..XX...X..X....X.XXX.X..X...X..........X.X..X.X.....X...X.X.X.X..X...X......X..XX..X..
.X....XXX.X.X.XXX.XXX.X...X.XX.XX.X.X..X...XX..X..XX.....X...X..X.XXX.......XX....X.X....XXX..X.X...
X.X..X..XX.X..XX.XX.X.XX.X.X....X...X.X....X.X.X.XX........XX.XXX..X....X..X.XX.X....XX.X.XX.XX...XX
.X..X..X.XXX.X.X.XXX.X..XX.XX.X.X....X.X..XXXX...X....XX..X...X...X.XXX.X.X...XX...XXXXXX.X.........
.....XXXX.XX.X.X......X.X.XX...X.....XX......X..X....X...XXXXX.XX..XXX..X...X.X.X......XX.X...XX....
..X..XX.X...XX...XXXX.XXXX....XX.X.......XXXXXXX.XXXX.XXX..X.XXXXX........X..X....XX.......X..X..XX.
.X....X...XXXXX.XXXX.X........XXXXX.......XX.X.XXXX.X.XXX.....X.XX....X...X....X.XXX.XXX...XXXX.XX..
..X......X...X..XX..X...XX......XXX..X.XX.X....XX..X.X.......X..X.XXXX..XX...X...XXXXXXXX.XXX...X..X
...X.X..X.XX......X.X.XX.X....X..XX..X.XXXX...XX.......XX.X.X.....XXXXX.....XXX.XX....XX.X.X.XX.X...
.X.XX..XXXXX.X...XXXX.XXX....XX.....XX......X..X..X.......XXXXX.X...XX.XX......X.X........X.X.X.X...
.XX....XXX.......X..X...X.XXXXXX..XX....X........XX.X.XX.X...X.XX.X..XX..X.X....X.XXX......XX....X..
..XXX......XXXX.X......X.XX.XX.XX..X.....X.X...X..X...X.X.XXXXX....XX..X....X..XX.XXXX....X..X..X..X
XX.XXX....XXXX..XX..X.X..X.XX....XX..X.......X.X......X.X..X..X..X..XXX..XX.....X.X...XXXXXX.X....X.
..X.....XX...X.X.........X.........X.X.XX...X.XXX.XXX..XX.X.XXX.X....X..XXX.X....XXX..XX..X.....X.X.
.X...XX...XXX..X.X..XXX.XX.X.X...XX.XXX...XXX...XX..X...X..XX.X...XX.......X.......X.X.X....XXX..X..
X.XX.X..X.XX......XX.X....X......X...XXX...X.....X.......XX.XX.X.X...X...X......XX...X............X.
