.XX.X.XXXXX...X.X..X..X.....X.....XX.....X.X.X...XX.X..XXXX..X.X...X...X.X......XX....X..X........X.
..X.X..XX.X..XXX..X.XXXX...X..X...X..X.XX..X..XXX.....XX...X.X...X..XX.X.X..X.XX...X.X.............X
XXXX...X..XX....X...X...XXX....X.X..X.....XX..XX.XXXX..XX.X.XX..XX......XX..X..XXXX.X....XX..XXX....
X......X...X...XX..XXX.X.XX...XX.......X.XX.X.X.XXX.X....X.....X.X.X.X...X..XXX...X..XX...XX....X...
X..X.XX..X.XXX.....XX.X..X..XX.X...X..XXX..X...XXX.X.X..X....X....X...XX...X...X..XXXX..X..X...X...X
....XXX..X.XXX.X....X..........XXXXX.X.XXXXX.X.X.XXX.XX.....X.X..XX.X....XX.XX.X..XXX.X..XXXX...X.XX
...XXXX..X.....X....XX.....X.XX..X.....X..XX..X.XX..X..X.X.XXX.X.X...X.....X.......X.XXX.X.XX.XX..X.
X...X....X...X..X..XX..XXXXXX..X...XXX.X.XX..X.X.....XXXXX...XX.X..XXXX....XX...X...XX.X.X.......X..
XX.XX..XX.X.X..XXXX..X.X..XX....XXX.XXX....X......X.X.X..............X.X...XX.X....XX........XX.XX..
..XXX..X..X...X.....X.X.XX...XX.X...X.XXXX.XX...XX.XX.XX.X.X..X.......X.X.....X.X...XXXXXX.....XX.X.
XX...XX..X.X..XX..X..X....XX......X....X.X.....X.....X..X..X.....X..XX...X.X.X.......XX...X.X.XX.XX.
XX....X..X..XX.....XXXX..X.XXXX.X.X....XXX.X.X.X...XX.....X.....XX.XX.XX...XXX..X..X..X...X..XX....X
X.XXXXX.X.XX.X...X..XXXX......XXX....X.......XX.X.X.....XX..X.XXXX.XXX.X...X.X...XX.....XXX...XXXX.X
X.....X.X..X....X.X.X.X.XXXX.XXX......XX....X.X.X.X....X..X..X.X..X.XXX.X...XXX..XX.XX.XXXXX.....X..
.X............X..X.XXX...XXXX.X.X....X.XX.X......XXX....X...X....XX.X.X....XX.XX.X...XX.X.X.X..X.X.X
XXX.XXX..XX..XX....X.....XX.......X..XX.X.X.....X.X.X..X.X....X....X..XXX.XXXXX.XXXXXXX...X.X.X.X...
...XX..XXX..XXX.XX......X....XX..X...X.X....XX.X..X..XXX..X.X..X.XXXX.XX.XX..XXXXX..X..X.....X.....X
...XX.X.X....X.XX......XX.XXX..XX.X....XXX.....XX..XXXX..XX....XXXX.XXX...X..XX..XX....X.X.....X.X.X
..X.XX.........XX.X..X.........XX.XXXXX.X..X..XX..X..XXX..XX..X.X.X.XX...X.X.X.X.....XXXXX..X.......
..XXX.%..X..XXXX..X.....X...X.....XX.XX..X...X.X.X....X.X...X.X.X.....X..XXXX..X....XXXXX..X.X.X....
.X.X..XXX..XXXX.X.X.....X..X.....X...X.....X.XX....X....X....XX.XX........XXXX.XX...X.XX...XX...X.X.
X.XXX.X...X....XX..XX...X....X....X.....X..X.X.X..XXX..XXXX..X.XXXXX......XXXX....XX.X..XX..X.XXXX..
X.XXX...XX.X.XX....X...........XXXX.X.XXX.X.X...XX...XX...X.X.X..X.X...X.X..XXX....XXX...X.XX....XXX
X..X..XX...X..X.X...X.X....X......X.XXXXXX....XXXXX.XX....XX...X..X.XX.XX..X.X..XX.X..X.X.X..X..X.XX
XX..X..X..X..X...XX..X..X.X..X.XX.X..X..X.X..XX.X...XXX.X....XXX....XX....XX...X.X.X.....X.....XX.X.
...X...XX...X...X.X.X...XX...X.....XXXXX.....XX..........X....X...XX..X..XX..X...X.X.XX..XXX....X.X.
..XX..X....X..X.X...X..XXX...XX.XX.X.X....X...XXXX.X.X..X....XXX...X.XX.X..X.X.....X..X.X...X..X....
.X.X.......XX........X...X..XX...X.XX.XXXX....X.XXX..X..XX......XXXX....X.....X.....X.X...X......X..
XXXXX.XXX..XX.XX..X.X........X..X..XX..XX...X..X.X...X..XX.XX.X....X.XX.X.X.XX...X..XXX......X.....X
X.X...X....X....X.....XX.XXX.X..X.X......XX.X.XXX.X....XXX....XXX..X..X..X......X..X..X..XXXXX.X...X
..X...X..X.....X.....X..XXX.XX.X...XXX..XX...X.XX....X.X...XXXXXX.XX..X.X.XXX.....X..X.X..X...X..XXX
....X.X.XXXX..XX.X..XXXXXX.......X.....X..X.X..XXXX.......X.XX..XX......XXXXX..XX..X..X...X.X..X.X..
...XXX...X.XX...X..XXXXX.X.....X.XX.X..X........XX.XX...X..XX...X....X...XXX.XXX.X..XXX.....XX......
..X...X....X.XX.X.XX...XX.....X......XXXX..XX..X..X...X.X...XXX.X.....X.X.X...X.XX..XX....X........X
XXX.....XX..X.X.X...X...XXXX...X............X..........X...X.X.....XX...X...X.XXXX..X....X.....X....
..XXXX..XXX.X.X...X....XXXX....XXXXX.X..XX.XX....XXX.X....XXXX..X......XXXXX..X.X.XXX...XXXXXXX.X.X.
.XXXX.........X...XX.X...X.X....XX...X.X..X..X.XX.X...X......X...XX.....X....X.X.XXX...XXX...XX..XXX
X...X.X....XX.XXXX....X.XXXX.....XXXX...XX.X....XXXXXX.X....X.X........XX..X..X..X.....XXX.....X.XX.
X...XX.....X.XXX....X.X..X..X..X.X....XXX..X..XXXXXXX..X..XX.....X.X..X...XX.X.XX.X...XX....X...X...
.XXX...X.X.X....X..XXX......X..X.X..X.X.XX.XX..X.X..X....XXXXX.....X...X...XX.X.....X....XX..X.X...X
XX........X.XX.X.X..X..X....X.X..X.XX......XXX.XX..X.X.X...X.XXX...X.XX..X.XX.X.X.X...XX.X...X...XX.
.X.XXXXX.X.......X..X.X..X.XX..XXXXXX....X.X.X.XX........XX.XX..X....X...X.X..XX.XX.X.X..X.X.....X..
XXX..XX....X.XXX....X...X...X.....X.X......XX.X.X..X.X..X.XX.....X..XXX...X....XX...XX..XXX.X.X.....
..X..X..XX......XX.X......X..X.XXX.X......X.........X.X.X.X..X.X...X.XXXX.XX.XXX....X.X..X.X....XXX.
...........X.X....X..X.....X..X.X.XXX.XX......XX..X...X..X.X...X.....X....XX.X..X.XXXX...XX..X..XXX.
....X......X.X...XX.X..........XX.XX...X.....XX..XX.XX....X.XX..XX..X.X...X..X.XXXX.XX..X.....X.XXX.
X....XXXXXX..XX..........X..X..XXXX..X.X..X.X.X..X...X...X...XXX.X.X.X...X..X.XXXX..X.XX.XXXX.X..XXX
.X..X.XX..X...X..X..X.X..XX.XXX.XX..XX.....X...X...X.........XX...........X.XX.....X.....XX......X..
.X.XX.X.XXX...X.XX...X.....XX.....XX..X.X...X.X....XXX.X..XXX.X.XX..X.X.X...X....X.XX.X.XXX...X.....
..X...XXXX.X.X.X..X..X.X....X...X...XX...XX...X.XX.....XX.X....XXX.XXXX.X....X.XX...X..X..X...X..X..
..XX.X...XX....X.XX..XX......X.X.X..X....XXXXX.X.X..X..XXXX..X...X...........X.XXXX.XXXXX..X...XXX.X
...XX......X..XXX.X.X......X.XXX.XX....X.X.XXXX....XXXX.X.X....XX..XX...X...X....X...X.....X.XXXX.XX
XX..X.X......X..X.X.X.....XX.XX.X....X.X.XXX...X...............XXX..X..XX....XX..XX....XX.XX....X...
XX.XX.X.XX.XX...XX.X.X..XX.XX...X.X..XX...XX...X.X...X.X..X.X.X.XX.....XXX..X........XXX..XXX...XXXX
..XX.....XX.X..X...X.X.XX...X.XX.XX.....X..XX....X....XXX..XX.XX..X.....X....X.X........X.X...XX.X.X
..........X.....XX...XXXX.X...X...X......X.X.....X..XXX..X..X..XX.X..X.X....X.....X....X..XX.XX.XXX.
....X.X.X.XXX.X...XX.......XX..XXX........XXX....XX....XX..X....X.X..XXXXX.XXX..X.XXXX.XXX.XXXXXXXXX
XXX.X.X.XXX..XX...XX...XXXX.....X.XX...X..X..XX.X.X..XX.X..XX..X..X...XX...XX...........X.XXXXXX....
...XXX..XXXX....X....X..X..X..XX...X..X.XXXXXX.X.XXXXX..X.XXXX...XX......X.X.XXX...XX.....XX........
X...XXXX.....X.XXXX.XXXX.XXX..XXXX..X......XX..X.XX.X..XX.XX..........XXX...XXXX.....X.....X....X..X
.....X..X..X.XX.XX.XX.X..X..XX.X.XX........X..XXXX....X..X..XXXX....X.X..XX.X...X.X.X....X....X....X
..X.X...X.XXX.X..XX......X....X.X...X..X.....X..XX...XXXXX..X..X........XXX..X.XXX.X.XXX..XXXX....XX
X........XX...X..X...X......XX..X......X..X..XX..X.XX.X..X.XXX.X.....XX..XXX.XXX.X..X...X..XX.XX.X.X
XXX.....XX.XXX......X...X..X.XXX.XX...X.X...XX..X.....X....XXX..XXXXXX.X...XXX...XX.XXX.XX.....X.X..
.....X...XXXX....XXX...X.XX.X.XXXX...X...X..........XX.XXXXXX.XX..X..X..X....XX..XX......XXXX.X.X...
.XXXXX.X.XXX....X..XXX.X......XX.X.X..X.X..X.XXX.X........X.XX.X...X.X.X..XXX.XXX...X..X...X.....X..
XX...X.XX......XX.....X.X.X.XX.XX.XX.XX.XX.X.....XX....XX.X.X.XXXX..X..X.X.X...X.....X....XXXX....X.
..XXX....X....X..XX.....X..X.XX..XXX....XX..X..X.XX.......X.....X.XX..X..XXX.X...XX.XX......X.X..X.X
X..XX.XX.X.X..X..XX..XX...X..X.X..XXXX.X..X..XX......XXX.....X...XX.XXX...X..XX.XX.XXX..X..X...XX.X.
.X.XX.....X.....XX....XX...X...X...X....X..X.XX..XX.X..X.X......X.X..XX.X.XXX....XXX...X....XXX.XXXX
XX.X.X....XX.........X..X.X.X.XX..............X..XX.XX.X...X.X...X.XXXXX..X.X..X..........XX..X.X..X
.XXXX..X.XX....X..X..X...X.X..X...X.X........X..X......X.X...X.X.X.XX..X..XX..XX.X.X.XXX..X...X.....
X.....X.XXX..XX......X..XX.X..X......X..XX..X.X.X.....XX.XXX.X......XX..X.XX.X...X........X...XXXXX.
..XX....XXX...........X.X.X.X.XX...X.XXXXXX...XX.X..X.....X..X...XX..XX...X..XX........X.X...X..X..X
.XX.........XX.XXXX...X.XX...X..X.X....X.......XXXX.XX.....X.X.......X.XX.X..X.XX..X..X.....X.X.X.XX
...XX.X.XX...XXX........XX..XX.X..X..X..XX.XX...X.XX.XX.XX.X.X.XX...XXXX.X.X.....X..XXX..XXX..X.X...
..X..XXXXX..XXX..XX...X..X...X..X..XX......XXX.X..X...X....XXX..X....XXXXX.XX.XX..XX..X.X...XX....XX
.X.X..X...X...X.XXXXXXX..X....X..XX.XX.X.XX.X..X.......X....XX..XX.XX.X...XX...X....X..XX...X.X.XX..
.X.X..XXX..XX...X.X..X.......X.X.X....XX.X.XX.X.X..XX.X.XX..XX........X....X....XXXX....X.X.X.X..X.X
.XXXX..X.X......X...X.X..X.XX.X.X.X......X..XXXXXX.X.X...XX..X.X.XX........X.X...XX...X.X.X..XX.....
..XX.XXXXXX..XX.....X..XXXX.XXX....X.........X..XX.X..X.XXXXX......X.XX......XX.X...X.X.XX..X..X.X..
XX....X..X.XX..XX.XX.X.......X.X....X..X.XXX.XXX...X....XX.XXXXX.....X.XX..XXX..X..XX...X...XX.X.XX.
.X....XX..X........XXX.......X..X..X.X.X.....X...X.XX..X...X...X....XXXX...X...XX.XX.XX.X..X.X..X.X.
X.....XX...XXXXX......X.X.X.X.XX.X.XXX.XXX.X..X.....XX.X..XX.X..X.....X.XX.X.....X............X....X
..X..X...X...X.XXXXX.X.X..........X.........XXXX...X...XX..X.X...X.X...XX...XX.X.XXX..XX.X..X.XX...X
X..X..XX....X.........X.XX.XXX.....X.X..X.X..XX..XXX....XX.....XX.XXXX.X.XX..X.XXXXXXX.....X........
X.XXXX..XX.X.X..XX............X..X..X...XXXXX...X.X.X..X.XX...........XX.X.X.......X......X....X..X.
.XXXXXX...X.X....XX.XX.XXX..X..XX.X.XXX.....X.X.X...XXX.XXX.......XX.XXX.X..X@...X..X..X..XXXX.X....
X.X....X....XX.X..X..XXX.X.X...X...XX.....X..X....X.XX.X.......X.XXXX.X.X..X.X.X.X...XX..XXXX.XXX...
X...X...X..X..X.X.......X......X........XX.XX...XXX.X..XXX.X.X.X.X...X...XX.XXX...XX......XX..XXX...
...X.X.X.XXX...XX.XXX..XXX.XX...XX....XX...XX.X.XXX.X.XX...X..X.X.....X.XX..XX.X...X....X.X..X.XX...
.....XX.X.X..XX.XX.XXX...X..X...X.X....X....XX.XX.XX.X..X.....XXXX..XXXX.XXX........XXX...XX.....X.X
..X.X..........X...XXX.....XXXXX...X....X..X.X...XX.....X.XX..X.X.XX..XXXX..X.XX.....X..X.X.XX......
..X...XXX..X..XX.XXX.XXX.....X.X..XX...X.XXXXXXX..X....X........X.....XX.X.X.X.X.X.X..XX..XX.X.....X
..XXX.X.X.XX.X.X...XX....X.....X.........XX..X..X.X...XXX...XXX..X.XXXX.XX..X...X..X...X..X..XXXXXXX
.XX..XXX.X...XXX.....X..X..X....XX..XX.XXX..X..XX.....XXX.......X.....X.X.......X......X..XX...X.X..
X..............X..X...X..XX.....X..X....XX....X............XXX.....X........X..X.XX.X..X...X.......X
...X......XX.XXXX.....XX....X..X...X.X.XX.X.XX..X..........XX...X..............XXXX.....X....XX.....
X..X..X..X...XXXXX...X..X.X...X.XXX.XXX.X.X.XXX...XX.X..XXXX.X.XX...X.XX.X.XX..XXX.X.XXX.X..X.X.X.X.
.X.X.X.X.....X...XX....X.XX..X...XXX.XX.X.X....X.....X..X..XX.....XX.X..X...X......XXXX........XX.X.
