..X....X...XX.XX.XXXX..X..X.....X...X.....X..XXX..X..XX..XX.XX..X..XX....X.X.XXX.X...XX....XX....X.X
...@..X....X...XX.XX.XX.XXX..X..XXX...X..X....X..X...X...XX..X.X.XX....X.XXX..XX.X.X....X.X....X.XX.
XXXX..X.XXXX.XXX.X..XX.XX.X........XX.......X.......XX....X.X...XXX.X..XXXX.X....XX.X.X..X..X.X..XX.
.XX...X.XXXX...X...XXX.X....XX..XX.X..X..X.X.X.X.X.X.X...X..XX.X.X..X..X....XX.......X.X....X.X.XX..
.X...X.X....X......XXXX...X....XXX..XX..X.XX.XX...XX.......XX.XX..X.X.....X...XXX.X.X....XXX.....X.X
.X.X.........X.X...X.X.XXX......XX..XXXXX....X.X..X...XX.....X.X.....X.X....X.X.XX..XXX.X.X....X.XXX
.X.X.XXXXX.XXX...X...X..X..XX.X..XX.XX...X..X...X.X..X.X....X.......X...X.....X.X...X.XXX..XX.X.....
.X..X...X..X..X..XX.X..X......XX..XX....X.X.......XX.XX.X.XX...XX....XX..X.......XX.XX..............
..X....X...X.X.X........XX.X....XX..............X..XX.X..X.X..X.....X.....X........XX....XXX.X..XX.X
...X...XXXXXX.X..XX.X.X.....X.......XXX...XX.XXX..X..X...X.X...X....X.....X.XX.XX.X.......XX.XX..XXX
...XXXXX.X..XX.......X.XXX.X..XX.XX.XXX.X.XXXX..XXXX.X......XX..X...X........X..X..X..X...X..X..X.X.
X.XX..X..X....X....XX..X.XX..X....X..XXX.XXX...XX..X.X...X...XX.X.XX....X....X...XXX..X..X.X.X.....X
X.X......XX.......X.XX.XX.X..XX...XX.XX.......X.X...X.XXX.XXXX..X..X...X...X...XX....XX.....XX.X...X
...X...XX.X.XX.....X.X...X.XXXX...XX....XXXX..XX.X..X....XXXXXX.......X.X.X....X..X..X.X..X.XX..X...
X.XXXXXXX...X.X...XXX...XX.X...XXX.X..X...X.X.XX...XX....X.X.........XXXXX.X.XX..X...X.X.XX.XX..X.XX
X....X.X........XX..XXXX.X.X.XX.XX........X..X....XX....XX....XX.XX.X...X.....X...X..XXX.XX.....XX..
...XX..X.X........X......XX...XX.....X..X.X.X...X...X.XX.XX...XX...XXX....X..X....X........X.X.X.X..
.X.....X.X..X.XX..XXX..XX....X...X...X.XXX...X..XX...XX.X..X..X......X....X..X..XXXXXX....X....X.X..
.X..X...X.X.......X.X...X..X...X...XX.X..X.XX.XX......X..XX..X...X...X.X..X.XX.X.X........X.XXXX..XX
X.XX....X..XXXX.X..X........XX...X..X....XX......XXXX.X....XX.XXXX...X...X.X.....X..X..X...XX..XXXX.
..X.X..XX..X......X..X....X..X.X...X.X...XXX.XXX.X.X.X...X...........X..XXX.XXX.X.X.X.XXXX..X.X...X.
.......XXX..XX...XX..XX..XXXXX.XX.XX.X..X..X.X.X.X...X.XX.X......X.XX..X..XX..X..X..X.X.....XXX.XXXX
X....X..X.XX.XXX...XX..XXX..X.....XX...X..X..XXXXXX.X...X.X....X....X..X.X.........X.X..X.X.X.X.X.X.
XXX...XX.XX.XXXX.......XXX....XXX.XX..X.......X..X...XXX.X...XX.XX......XX.X..XX....X..XXX.X.XX.XX.X
XX.X.........XXX.X.XXX..X...X..X........X.XX.......XX.X.X..X.X...XX.XXXX...X.....X..X.XXX..X..XX...X
X..X..X.XX.X.......X..XX.X..X.X..X..........X....X.....X...X..X...X........X.X...XXXXX.X.XX..XXXX.XX
..........XX..XX....XXX.X..XX.X....X.X.XXX...XXX..X.XX..X..X....X....XX.....XX..X.X.XXXX.X..XXXXXX.X
XX....X..X....X..X...XX.X.X..X.X....XX..XX.X.XX..X.....XXXXX....XXXX......X.XX.X.......X......X.X...
......X...........X..X...X.....X.X..X.X.X...XXX.....XXX.X..XX.XXXXX.X..XX..X.X.X.XX.X..XX...XXXXX.X.
..XXXX.X.......XXX.X.XX...X.X..X..XX..X..XX...XXXX......X.....X.X.XX.X.XXX...XXXX.......X.XXXXX.X.X.
.X.....X..X.XX...X...X....X.XX..X.X.XX......X.X...X..X..X....X.XX..XX.XX...XX...............X.......
.XX..XX.XXX.X.X....X....X........X..X...XXX.XX...X....XXX..XX.........XX....XX.X..........XX.XX..XX.
..X.XXX....XX...X.X.XX...XX...XX.X.XXXX.X..XX.X..XX.X.XX..XX.X...X.XXX.XX.X...X.......XX.....XX.XX..
..XX...X...........X..XX....XX..X.....XXX.X....XX.X.XXX.X....X.X..X....XXXX...XX.XXXX..XX...X.XXXX.X
.X...XXX......X..XXXX.X.X..XX..X.XXXX..XX.....XX..X...XX.XXX.......XXXXXX..X.XX..XXXX..X.XXX.X..XXX.
....XX....X..XX..XXX....XX..XX........XXXXXX.X..XX.X..XX.....XXX...X.XX...XXXXX...XXX....X..XX.X....
....X..X.X.X.XX..X.....X.XXX..X...X...X..XXX.......XXXXXX....X......X..XX..X....X.XX..X.X...XXX.X...
..XX..X.XXX..XX.XXXXXX..X.X....XX.X...XX.......X..XX..XXX......X......X..XX..X.X..XX..X.XX......X.XX
..X.X.X...X..X......XX..X...X..XX..X..X.X..X..XX....X.XXXXX..X...X..XX..X..X.X...X..X.X...X..X.X....
.XX...X....X.X.XX...X...X..X.X.X..X...X......X.XXX....XX.X........XX..X.X...X.X...XXX....X...X......
.X..........X..X.X......XXX.X.X.X...XXXX....XXX..X.XX...........XXXX.X...XXX.....X.X.XXXX.XX....XX.X
...XX.....XX....X.X.X..X..X.XX.X.XXX...XXXX...X.....X.XX...X....X.XX..XXXXX...X.X....XXXX.X.XX....X.
.X.X....X.X.X..XX.XXXX.XXX..X.XX.X..X....XXXXX.......XXX..X.X..X...XXX......X..XXXX..X...X.......XXX
.X.XX...XX.X..XXXXX.....X.X..XX..X.......X.XX..X.X.XXX.XX......X....................X..X..XX.X.XXXXX
X..XXXX..XX.XX....XXXX...X..XX..X.XX.X.....XX..X.XXX.........X......XX.....X.X.X..X...X..X...X.XXXX.
.....X.XXX....XXXXX.X.X.XXXXXXX.................X..X...X...X.....X.X..X..XX......XXX...XX..X.X......
XX.XX....X.X...X...X.X...XXXX.........X.X.X.X.XXX...XXX.X.X.X.XXXXX.XXX.XXX..X.X......XXX....X.X.X..
X.XX.XX.XX.XX..XX.XX..XX..XXX..X...XX.X..X..........X..XX.X.XXXXX.X..X.....X..........X...X.X......X
XXX..X..X..XXXX..XXX...XX..XXX.XX.X....XXXX..XXXX..X..XX.XXX.X..XX.X.X.XX.XX.XX..XXX.....X.X....XXX.
XX...XX.X.....X.....X.X.X.X.X.....XXX..XX..XX.XXX....XX..XX..X...XXXXX..XX.X..X.X....X.X.XX..XX..XXX
X..XX.XX.X..........X.....XX...X.XX....X..........X..X...X.X.X..X.X.X....X.XX..X......X..XXXX.XXX...
X...X..X...X..X......X......XX.X..XX..XXXX.X.....X..X.X.X..XX.X.X..X..XXX.X.X.X...XX...XXX..........
X....X....X...X.XX.XX.....XX...X.X.X..X.XX.X..X...X..XX.XXX.X....X.X....X.............X.XXX..X..X..X
X.X....X.X..X.XX..XX..X..X..X...XXX.........X.X..XXXXXX.X..X...X..XX.X.XXX..X..X..X..XX...X.X.....X.
XX.XXX.XX.XXX...X.X...X..X.X.XX.XXXX.XX........XXXX...X.XX....X..XXXX..X...XXXX...XX......X.X..X...X
..X..X....X.XXX......XX...XX..XXX....X..X.X.X.....X.XXXX..XXXXXXXXX...X........X.X..X..XX...X.....X.
...XXXX....X..XX.X.....X...X...XXX..XXXXX..XXX.X..XXX...X..X.X..X.X..XX............XX.XX.X....X..XX.
..XX..XX.XXX.X...X.XX...X..XX.X........XX.X.XXX.........X.....XX.X.XXX..XX....X.XXXX........X...X.X.
..X..X.XXXX.X....X..XXXX..X..X.....X..X....XX...X.X.....X......X..X..XX.......X....X..X.XX..XXXX.XX.
X..XX...X.....X.XX..XX......XXX.X......X.X.....XX.....XX...X.......X.X.XX.X.X...X...X.X..XXX...XX...
.X..X.XXX.....X.X........X....XX....XX..X..X..XX...X.......X.XXX...X.X.X.X.X..XXX.X.XX...XX..XX.X.XX
X..X..X.XX.X.....XXX....X.X..X.....XXXX.XXXX....X.X......XXXX.X.XXX.XX..X.XX.X...XXX.X..X.....XX.XX.
.....XXX.X.X.......X..X....X.X......XX..X.XX..XXXX....XXX.XX..X.XX.XX....XX..X.......X.....X..X.XXX.
..XXX...XX...X.........X.X.XX...XXXX.XXXX.X..XXX.X...X.X.X....XX......XX........XXX...X..X.......XX.
.X........X.XXXXX.X.XX...XX..XX...X..XXXXXX...XX.X....X..X....XX...X.XXXX..XXXX........XX.....X...X.
.XX.X..X.X.XXXXXXX...XXX.XXXX..X......X...X.XX........XX.......XX.X..XXX.XXX.X.....X.X...XXX..XXX.XX
....XX...XXX.X.XX...X..XX.X..X.X.X.XX.........X.X..X...XX......X.X.XX..X.XX.XXXX.X.......X....XXX...
...X.......X....XX....XXXXX.X.....XX....X.XXX..X...XX.....X..X...X.X....X..........X..XX..X.X.XXXXXX
XX..X..X...XXXXX.X.....X..X.....XX....XX.X...X..X...X.XXXX.X..XXX.XX...X..XX..X...XXXX..XXX...XXX..X
.X.XX..X..XXXXX.XXX..X........XXX..X..........XX.X.X..X..XX..X.X..XX........X.X.X...X.....X...X.XX.X
........X..X.X....X...X...X.X....X...........XX...XX...X..X.X..XXXX......X.....XX...X.....X.X...X.XX
......X..X..XXX...XX......X....X.X....X......X...X.X.........X.X.....X..X...XX..%.....XX.X...X...XX.
X.XX..X.....X.....X........XXX.X.X.XX..XXX.X...X..X..XX...X..X.X.X...XXX.XX.X.X.X.......X.......XX..
...X..XX.X...XXX.X...XX..X....XX.XXXX.X...X.X..XXX.X...X.XXX..XX.....X.....X.X..X.XXX..X..X.X.X.....
.X.X..X...X.X.X....X..X.X......X.X..........X..XX...X.X..X..X..X.......X..XXX......X...XXX..XXXXX...
....X........X...XX...X...XX..XXX.X...X.X.....XXX....X.........XXX.X.X.XX..X..XX.XXXX.XXX.XXX.XX...X
...XXX....XX.XX....X..XXX.....XXX.X.....X.X.........X...XX.......X.XX.XXXXXX.X...X.X.XX....X.XX.....
X.X.X....X..XX.XXX..X..X.XX..XX.X..X.X.XXX..XXXX...X.XXX..X...X..X.XXXXXXX...X.XX..XX..XXX....XX..XX
.X.X.X.X..XXX.X...X.XX...X.X..X.XX.XXXX.X...XXXX...X.....XX.X.X..X...XXX.XX....X....X..XX......X.XXX
...X..X...X.X.X.XX........XX....X.....XXX.X..XX....X.XX.X...XX.XXXX....X.X.X....X.X..X......X...X.XX
XXX.X......X.X.XX..XXX.XXXX....X..X.X.....XXX.XXXXX..XX.X.X..X.....X....X...XXXXX.X...X.X..X........
..XX....XX.X.X.X...X..X.X....X.X.X......X...XX..X.X.X.XXX..........X..XX..X....XXX.X.........X..XXXX
.......X..XX..X......X.XXXXXX...XX..X.XXX......XX...XXX.X.X.X..X.XXX......XXX..X..X..X.X....X..XX.XX
..X..XXX...XX......XXX.X.....X..X......XX.X......XX..XX.XX...X.....XX........XXX.XXX..........X..X..
X....X..XX......X....XX.X.X......XXX..X.XX.....XX...X.XXXX..X.XX....XX.X..............XX.XX.X..X....
.XX..X.XX..X....XX.XX..X.X.X....XX..X.XXX.XX.X..XX..X...X..........XX..X...X.......XX..XXXXX.....X.X
...XXX..XX.XX..X...X.XX....XX..X...XXXXX..XXX...X.XXX..X......XX.......X.X..XX.X...XXX.X.X.X..X..XX.
X...X..X..X....X....X.XX.XXX...X.XXX.X....X...XXX.....XX.X...XX....XX..XXX.X.X...X.X......XX.X.XX..X
.X...X...XXX...XX.XX..XX.........XX..X.....XX......X...X.X......X....XX.X.....X.....X.XXXX.X.XX.X..X
....XX.X.XXXX..X.....X........XX.XXX...XXX..X.......X..XX..XX.XX..XXX.X..X.X......X.X.X...X..X...X.X
.X.XX..XXX.X...X.XXX....XX.X..XX.XXX.XX.X...X....XXX.....X.....XX....X.X..XX....X......X..X..XX.X.X.
X.X..X...XXXXXXXX.X.XXX..X.XX..X....X.XXX...X.X.XX.X.X..XX...X.X...X.XXX.X...XXXX..X..X.XX..XXX..XX.
..XXX.X.X.XX.XX...X..X......XXX..X...XX......XXXX..XX.XXX..XXX.X.X..X...X.XXXX.X.X...XX.XX....X...XX
X..XX.XX.XXXX.XX..X.X.X...X..........X..XX...XXXX...X.X..X.XX.X.X.....XXX.X.........XX...X.XXXXXX...
....X.X.X..XX..XXX....XXXX.XX......XX..XX..X..X....X.XX...XX..X..X...XXXXX..........X.......X.......
..X..XX.....X.XXX.X...X..X..X.X.........XX.XXXX....XXX..X....X.X....XXX.X.X.X...XXX.....XXXX.X.X..XX
X.....XX......XXX.XX.X.XX....XXXX......X.X.....XX.XX....XX..X.XX....X.X.XXXX.XXXXXX...XXX.XX....XXXX
X...X....XX.X.XXX.....XXX.X..XX..XX..X.....XXXX..XX.X.X.X..XXX..XX.X....X.X..X....XX..XXX.........X.
.XX.....X.....X..X.XXX...XX.XX.X.X.X..X.......X...X...X.X.X.X.XX.XX.X.X...XX.X....X.XXX.XX...XX.X...
XX.....X....XX..X..X.XXXX.XXXX..X...XX.XX.X.X......X.X.X.X...X.....X.X.X.X.X..XXX...X..XX.X........X
