X.....X.X.X...XX...X..X..X......X..X............X.XXX...X....XXX...XX.XXXXX...X.X.XX.X.XX.X.........
...X....X...XXX..XX..X...X.....X......X........XX..XXX.X.X....XX.XX.......XX..XX..XX......X.....XX..
XX...XX.XX.X..X...XX...XXXX.XXXX...X........XX....X....X..X.XX...XXXXX..X.....X...XX....XX...X..X...
XX..XX...XXX.......X..X..XX..XX.XX.XX.XX...X.XX..XX...X.........X...X.....X...X....X.X.X....XXXX.X.X
.....X..XXX.X....XXX.X.X.XXX...X.X.X....XX..X.X..XX.X.XX..X....X.X.X.XX...X..XX.X........XX..X......
...........X..XX..XXXXX.......X..X....X.XX.X.......X...X.X..X.........X.XX...X....X...X......X.X.XX.
..XXXXX...X........X.XXXX.X..X.X..XX..X....X.X.X..X.XXXX..XXX.X...........X......XXX.X..X...XX....XX
...X.X..XX.......X.XXXX.X.XX..X.X.XX...XX.XXX....XX..X..XX..X.X.X.X.X...X.XX....X.XX..X....XX....X..
X..X...XXXX.X.X..X.X...XX.X........X.XXX.XXXXX..XXXX..XX.X..X.X..X..X.XXXXX............XX.XXX.XX.XXX
.......X..XXX..X.X......XXX.....XXX....X......X.X...XXX.X..XX....X..XXX.XX...X.X..XXXX.X.X.....XXXXX
.X.XXX...X.XXX.X.XX...X...XXX...X.....X...X..X...X..X.X.XX.X...X.XX....X..XXX......XX.XX.......X....
.X.X.XX.....X.X...XX.XX............XX..XX...XX.X.XX....X..X......X.....X..X..X.X...XX..XX.X....X..X.
..XX...XX..........X...X....X.....X..X.X.XXX.....X.X.XX...X...X.X..X.X..XX..X.XXX......X.X.X......XX
X....XX.X...XXXX.XX..X.X.XXXX..XX...XXX...X...X..X....XX..X......X.XX.....X.XX....X.XX..X.XX..X.XX..
..X..X.....X.XX...X....X.XX..XX....X.XX.XXX.XX..XXX......X.......X..X....XXX.XX..XX....XX..XX..X....
....XX...X.X.X..X..X......XXXX....X.XX..XXX.X..X.XXXXX..X.X.XXXX....XXX..XXXXX.X...X.XX...X.X..X.X..
........X..X.X.XXX.X..XX..XXX.X...X..XX......XXXX.X.XXX..XXX...XX.X........X........XX...XX.X.X.XXXX
X..X.X.X......X....X........X.XXXXXX..X..X...X...X.XXX.....X.XX..X...X.X.XX.X..X..X....XX.XX.X...X..
...XX...X.X.X.X....XX..X.XXX.....X.X...XXXXX.XXX.XXX.XXXX..XXXX..XXXX..X.XX..XX....XXX.XX......X....
.XXX.X...XXX....XXX..XX.X..XX.XX...X........XX.XXX....X.X.XX.X...X.X....X..X....X.XX.XXX....X.X....X
X.X.XX.XXX..XX.X...X.......X.X.X..XXX....X...XXXX..X.XX..X.....X..X..XX.X...X.X.XXX....X....X.X.X.X.
..XXXX..XX..X...X.............XXX.X.....X.XX..XX..XXXX.X..XX........X..X...X.X..XXX.....XX...X...XX.
X.XX.X...X...XXXXX.X...XX.....XX.......XX....X..X.XXX.X...X...XX..X..X.X..XXX...X....X..X...XX...X.X
X.X.X......XXX..XXXXXX......X..X..X...XXXXX.XXX.X..XXXX........X.X..X.XX.XXXX.XX...XXXXX.XX....XXX.X
.X..XX..XX............X.....X...XX........X.XX....X..XXX...X.XX.X..XXXX...XX..X.....X....XX.XX.X....
X.X....X..X...XXXXXX...XX.....XXX..X.X....X....X...XX..XX.X......X.....X...X.X.X..XXX...X.XX...X...X
X.XX.X.XXXX.X.X...X.XXX...XXX..XXX.X.X....XXXX....X..XX.X.X....X....XXX...XXX..X.X....X.X...XXXXX.XX
X..X.XX.X...X.X...X.XXXX..X.XX..XXXX.....X.X.XXXXX..X.....X..XX....X..X.X.X.X....XXX......X..XX..X..
.........XX.X.X....XXX..XX.XXXX.X.X.XX.XX...X..X.X..XX...XX.XX...X......XX...X.XX.XX.XXXXXX.XX..X...
.X........X.XXX.X.XX.X...X.X..XXX..XXX.XX.....XXX.X.....XXX...X....XX....XX..XX.X......XX......XXXX.
...X..X...XX..X.....XXX..X.X..XX....XXX.XX.X.....X...X..........X.XXXX...X.X..X..XX.X.X.X..X...XXX..
.X.....X.X...X......XXXX..X.XX.X.....X.....XX...XXX.X...X.....XX..XX.XX.XX.X.XX..X...X....XXX...XX.X
X..X.X..X.....X.XXX.XX.X..XX..X.X.X.....X.X...XXXX........X..XX....X.X.X.X..X..X.XXX.XXX.XXXX..X....
..X.X..XX......XXX.X....XX..XX.X......X....X.X.XXX.X.XX.XX..X.X..XXXXX.X.X..X.X....X.......XX...XX..
.X...X..X..X..XX.X.X...XX.....XX.XXXX..XX.XXXX....XX..XX........X..XX.XXX.X..X...X....X..XX..XX.....
X.X.......XX...XX..X.XXX..XXX.XX.XX.XX...X.X.X.XX.XX.X....X.XX....XX.X........X.X..XX...X.X.X......X
.....X...XXXX..X..XX...X..X..XX.XX.X..X..X.X...X.XXX.X..XX...X.X....X.X....XX.X..X..X..X.X......X.XX
..X...X..XX....XXX..X..X...........X....XX.X.....X....XX....X....X...X..XX.X....X....X.X...XX..X....
..X......XX..X...XX.X.XX..X.....XXX....X....XX.XX..X..XXXX....X..XXXX...X...XX..X.X...XX....XX...XX.
XX.XX.XXX...XXX...X.XX..XX..X.X.X...X...X.XX.X.X.........X.X.XXX....XX.XXX....X.X..X...X..XX.X.XXX..
.X..XX.....X..XX.....X.X.X....X..X...XXX...X......X......XXX.....X..XX..X.X.X..X.X.XXXXX.X.......X..
.XX...X..X...XXX...XXX..X.X........XXXX..XX.X.X.X...X.X.XX.....X.X..X.XX.......XX........XXX...X.X..
....X..X..X.X.X....X...X.....X...XX...XX....X.XXX.XX.X.....XX.X.X..X.X..X..XXXX.X.XX....X.X.XX......
......X.XX..X...X....XXXX.XX.X..XX..X....X....X..XX...XX.X...X...X.XX.XX...XX.....X..X.XXX...X......
XXXX.X.XXX..X...X...XX..XX.XX.X.XXXX.....XXX.XX..X..X.X..X....X.XX.X...X..XXXX....X..X....X.X..X..XX
..X..XX.XXX..X.....X.XX....XX..XXX...X.X.....X.X..X..X.X.X.X.XX.XX...X.X.X.XX.X....X.XXXX........XXX
.X.X...XX......XXXX.X.......XXXX.....X.X...X.....X.XXX...X.X...X....X..X.XXX..X....X.X.....XX.......
.X..X.....XXX.....X.X.X.XXXX.....XX..X..X.X..XX.X.XX..X...X.X..XXX...XXXXX..X.XX.XX....X...X...X..XX
XXXX.XXX.....XXX...X.XXX.....X...X..X.XX.....X..XXX.XXX....X..XXX.XX..XX...X.XX.XXX......X...X......
.X....XX...XX..X.X..X.X.X......X.X..XX...XX..XX....X....X......XX......XXXX.X.XX.XXX..X.X......X.X..
X....X..X.XX...XX.X...X..XXX..XX..XXX...XX..XX.X.X.X.XXX..XX.....X.X.XXX.XXX.X...XX...XX..XX........
XXXXXX....XXX..X..X...X.X....XX.X..X..XX......X.X....XXXX.X.....X.X....X.X.X...XX..X........XXXX.X..
..XX.X..XX..X..X..X.XXXXXX..X.XXXX.X.......X.XX..XX.X..XXXX.....X....X..XX.....XXXXX..XX....X......X
........X..X.X..X......XXXXX...XX...XX.XX...XXX..X....X..X......XX....XX...X....X....XXX...XXX.X.XXX
X.X.X..X.X.....X..X.XX..X..X...XXX...X.X.X...X.......X.......X.X..X.XX..X..XXXX.........X...XX..X.X.
XX.XXX..X..X.X....X.........X....XXX..X.XXXX....XX....X..X.X..XX.X....X.X.X...X.X....XX..X.X.X.X....
X...X.X.XXX.X.X..X.....X..XXXX...X......XX..X.XX.X..XX...X......XXXX.X.X.X.XX.X...XXX.X..XXXXX..XXX.
X.X..X.XX.X.X..XXXXX.X...XXXXXXX.X...X..X.X...X.X..XX.X.XXX.X..X....XX.X.X.XXXX.X.XXX.X.X.X...X..X..
X.XX..XX..XX.......XX...X..X...XXX....XX...X..X.X.X..........XX......X.XXXX.X...XX.XX..X..XXX..X...X
..XX.XX.X.XXX....XXX.XXXX......XXXX...X..XX.X.XX...XX....X..X..XX.X.XXX...........X.XXX.......X...X.
X.X......XX.XXX..XX...X......X.XX.XX.X.X..........XXX.......XXX.XX..X.X.X..X.X.XXX...XX..X.X......XX
X.X.....X...X.X...XX.X.X.XX..X..XXXXXX..XX......XX....X.X..XXX.X.XXX.X.X....X..X...X..XXX.....XXX..X
......XX.X.X....X.X..X..XX...XXXX..X.X..X..X....X.X..XX.XXXXX....XXX..XXXX.XX...X....X.....X.XX.X.X.
XX.X..X..XX.X.XX..XXXX...X.X.XXXX.XX.X.X..XXX.X...X.XXX...X..XX.X.XXX.X..X.XX...X.X..X....X...XX...X
X.X..XXX..X.X.X...XX.X.....X.X.......X.X.....XX.....XXX.X.X.XX....XX....X.X...X.X.X..X.XX..X....XXXX
X....XXX..XX..X.XX......XX...X..X.XX...X..X...XX.XX..X...X..........X.....XX.X....X.....X.....X.X..X
.XX...X..XX....X.X..XX.X.X..XX..X.X..X..XXX.X....XXX.XXX..X.X.XXXXX.X.X..X..XXX.XX...X....X.....XXX.
.X..XX.X................X.X..XX.......XX.XX.XX.X.....XXX.X...X...X.X......X.X.X........X.X.X.....X..
..XX..XX.X.X.X...XXX.X.X..X.XXXX..X.X.X.X...X.XXXXXXXXX........X.XXXXX...X....XXX..XX.X.XX.X..X..X..
...X.XX.X..XX.XX.X...XXX....X.XX....X.X.X.X.X..X...X.X.X..X..XX....X.X.X...XX....XXX.X.X.X.XXXX.X..X
XX..XXX...X....X.X.X...X....X....XX.X.XX.X.XXX......XX...X.X...X..X..XXX.X....XX.....XX..XX...X..X.X
..XX...XX.XXX.X....X.XX....XXX.X.X.X.....X....X...X.X.....XXX...XXX.X....XX.X.X..XX..XX.XXXX..X.X..X
....XX..XX.....X.XX.X.X.XX.X.XXX...X.X.XXXXX.X...X......X..X....X.X.XX.X........XXXX....XX.XXXX..X..
.X..X.X.X...X...X...XXXX..X..X...........X..X.X...X.X.X...X..X..X..X.X.X.X.XX.X..XX..X..X..XX.XX.XXX
..XX.XXX.......X.XXXX.X..X....X..X..XX...X.X.X.X.X.............XX........X....XXXX.XXXX..X..X.X....X
X..X...X.......X...X..X.XX..X..X.X..X.....XX.......X.X....XX..X.X..X..X..X....XX.X.X...X......X..XX.
....X...X...XXXX.X.X.X.XX.X..X.....X..X.....X.XX.X...XX.....XX.X....X.XXX.........X..XX.X..XX...X...
.X.XX...X..X..X.X...XX.XXXXX......X..X........X..XXX...X..X.X.X....XXX.X....X..XXX..XX..X.X..X....X.
...XX..X........X.X...........XX...X.XX.XX.X..X...X.XX.X.....X..X.X..XXX.XXX...XXX..X......XXX.X.X.X
.XXX..X..X.X..X.X.......X.XXX.XX.X..XX.....X.X..X.X..X.....XX.XXXX..XXX.XXXXX..X....XX....XX.X...X.X
X.X.X..XX...X..X....XXXX.XXX..X.X.X......XXX..X.XX.X.X.XXX.X....XXXXXXX..X.....X..XX...X...X..X...XX
.XXXX...........X...XX..X..X.X..XXX....X.X....XX.......XXXX....XX...XX......XXX..X.XXX..XX...X..XXX.
...X...X.XX.XX.XXXX.XX........XX........XXXXXX...XX....XX...XXX..X.....X.......X.XXXX.....X.XX..X...
X...XX.XXX.............X.XX....X..XX.XXX..X.......XXX.X...X....XX.XX....X...XXX.X...X.X.X...XX......
..XX.X..X...XX....XXXX.X....X..X..XXXX.XX.X..XXX..XX.....X...X..X..X..X....X....X...X....XX..X.....X
XX.X.X.X..XX.X..X...X.X.X.XX....X.X..X.XX..X......X.XXX..X....X.....X.XX.XXXX.X.X..XXX....XXXX..XX..
.X.....X.X..X.XXX.XX.XX..X...X.....X..X.XXXX..XX..X..XX..XX.X..X..X.X.X...XXX.X....X.XX...X...XX.X..
.....X..XXX..XXX.....X...X....XXX.X.XXX..XX......XX.XX.X.XXX..X.XX.XX..X.X.X......X..X....X.......X.
XXXXX....X.XX....X....X.XXXXX...XX..XXXXX..X..X..XX.XX......XX...XX...XXXX.XX....X.XX.....X..X...X..
X..XX......X.......XX..X...XX.X..X.XX..XX....XX....X...XX..XX...X...XXX........X..X..XXX....X.X.X..X
XX.X........X.X.XXX.XX..XX......XXXX...XX.X......XXX...X....X.XXXXXXX.X.......X..X..X...%.X..XXX.XX.
...X...X.X...XXXX.X...X....X....XXX...XXXX...X....X.XXXX..X......X......XX.XX.X...X.XX.......X.X....
X......X.......X..XX.X.X.X.........X..X...XX.X.X........X........XX....XX.....XXX...X..X..XXX.XX...X
.XXX.X..X.XX.X..X..X..........XXX.X...X..X...X....X......X...X..X...XXX..XXX..X.X.XXXXX.X..........X
XXXXXX..X.XX..X.XXX..X....XX.....XXXXX..X.....X.XX...X......XX..XXX.X.....X..........X....XX..X..X.X
....XXX.....XXX..XXX..X.....XX..X..X.X.X.XX..XX..X..X.X.X.X..X..X.X...X..X....XX....XX..X.XXX.X..XX.
XX...XXXXX.X....X.XX.X.X...X.........X..XX...X.X.X..XXX...X..X.X...X.XX.XX..XXX..X...XXXX...X.......
.XX.XXX...XXXX.X.X..X..XXX.XX.......XXX......XXX......X..X.X....X....X.XX.X..X.X...X......X...XX.X..
...X...X.X.X.X..X.XX..X.XX.X..XX....X.X.X.X......X...X......X........XX.X.....XXXXXX.XX.......X.X..X
XX..X.........@..XXX...X...X.X.XX..XXX...XXXX....XX...X....X.XXX...X.X.X...XX.X.X.XX..X..X.X.X.....X
